AAA	 
AAB	、
AAC	。
AAD	・
AAE	ˉ
AAF	ˇ
AAG	¨
AAH	〃
AAI	々
AAJ	―
AAK	～
AAL	‖
AAM	…
AAN	‘
AAO	’
AAP	“
AAQ	”
AAR	〔
AAS	〕
AAT	〈
AAU	〉
AAV	《
AAW	》
AAX	「
AAY	」
AAZ	『
ABA	』
ABB	〖
ABC	〗
ABD	【
ABE	】
ABF	±
ABG	×
ABH	÷
ABI	∶
ABJ	∧
ABK	∨
ABL	∑
ABM	∏
ABN	∪
ABO	∩
ABP	∈
ABQ	∷
ABR	√
ABS	⊥
ABT	∥
ABU	∠
ABV	⌒
ABW	⊙
ABX	∫
ABY	∮
ABZ	≡
ACA	≌
ACB	≈
ACC	∽
ACD	∝
ACE	≠
ACF	≮
ACG	≯
ACH	≤
ACI	≥
ACJ	∞
ACK	∵
ACL	∴
ACM	♂
ACN	♀
ACO	°
ACP	′
ACQ	″
ACR	℃
ACS	＄
ACT	¤
ACU	￠
ACV	￡
ACW	‰
ACX	§
ACY	№
ACZ	☆
ADA	★
ADB	○
ADC	●
ADD	◎
ADE	◇
ADF	◆
ADG	□
ADH	■
ADI	△
ADJ	▲
ADK	※
ADL	→
ADM	←
ADN	↑
ADO	↓
ADP	〓
ADQ	ⅰ
ADR	ⅱ
ADS	ⅲ
ADT	ⅳ
ADU	ⅴ
ADV	ⅵ
ADW	ⅶ
ADX	ⅷ
ADY	ⅸ
ADZ	ⅹ
AEA	 
AEB	 
AEC	 
AED	 
AEE	 
AEF	 
AEG	⒈
AEH	⒉
AEI	⒊
AEJ	⒋
AEK	⒌
AEL	⒍
AEM	⒎
AEN	⒏
AEO	⒐
AEP	⒑
AEQ	⒒
AER	⒓
AES	⒔
AET	⒕
AEU	⒖
AEV	⒗
AEW	⒘
AEX	⒙
AEY	⒚
AEZ	⒛
AFA	⑴
AFB	⑵
AFC	⑶
AFD	⑷
AFE	⑸
AFF	⑹
AFG	⑺
AFH	⑻
AFI	⑼
AFJ	⑽
AFK	⑾
AFL	⑿
AFM	⒀
AFN	⒁
AFO	⒂
AFP	⒃
AFQ	⒄
AFR	⒅
AFS	⒆
AFT	⒇
AFU	①
AFV	②
AFW	③
AFX	④
AFY	⑤
AFZ	⑥
AGA	⑦
AGB	⑧
AGC	⑨
AGD	⑩
AGE	 
AGF	 
AGG	㈠
AGH	㈡
AGI	㈢
AGJ	㈣
AGK	㈤
AGL	㈥
AGM	㈦
AGN	㈧
AGO	㈨
AGP	㈩
AGQ	 
AGR	 
AGS	Ⅰ
AGT	Ⅱ
AGU	Ⅲ
AGV	Ⅳ
AGW	Ⅴ
AGX	Ⅵ
AGY	Ⅶ
AGZ	Ⅷ
AHA	Ⅸ
AHB	Ⅹ
AHC	Ⅺ
AHD	Ⅻ
AHE	 
AHF	 
AHG	！
AHH	＂
AHI	＃
AHJ	￥
AHK	％
AHL	＆
AHM	 
AHN	（
AHO	) 
AHP	＊
AHQ	＋
AHR	，
AHS	－
AHT	．
AHU	／
AHV	0
AHW	1
AHX	2
AHY	3
AHZ	4
AIA	5
AIB	6
AIC	7
AID	8
AIE	9
AIF	：
AIG	；
AIH	＜
AII	＝
AIJ	＞
AIK	？
AIL	＠
AIM	Ａ
AIN	Ｂ
AIO	Ｃ
AIP	Ｄ
AIQ	Ｅ
AIR	Ｆ
AIS	Ｇ
AIT	Ｈ
AIU	Ｉ
AIV	Ｊ
AIW	Ｋ
AIX	Ｌ
AIY	Ｍ
AIZ	Ｎ
AJA	Ｏ
AJB	Ｐ
AJC	Ｑ
AJD	Ｒ
AJE	Ｓ
AJF	Ｔ
AJG	Ｕ
AJH	Ｖ
AJI	Ｗ
AJJ	Ｘ
AJK	Ｙ
AJL	Ｚ
AJM	［
AJN	＼
AJO	］
AJP	＾
AJQ	＿
AJR	｀
AJS	ａ
AJT	ｂ
AJU	ｃ
AJV	ｄ
AJW	ｅ
AJX	ｆ
AJY	ｇ
AJZ	ｈ
AKA	ｉ
AKB	ｊ
AKC	ｋ
AKD	ｌ
AKE	ｍ
AKF	ｎ
AKG	ｏ
AKH	ｐ
AKI	ｑ
AKJ	ｒ
AKK	ｓ
AKL	ｔ
AKM	ｕ
AKN	ｖ
AKO	ｗ
AKP	ｘ
AKQ	ｙ
AKR	ｚ
AKS	｛
AKT	｜
AKU	｝
AKV	￣
AKW	ぁ
AKX	あ
AKY	ぃ
AKZ	い
ALA	ぅ
ALB	う
ALC	ぇ
ALD	え
ALE	ぉ
ALF	お
ALG	か
ALH	が
ALI	き
ALJ	ぎ
ALK	く
ALL	ぐ
ALM	け
ALN	げ
ALO	こ
ALP	ご
ALQ	さ
ALR	ざ
ALS	し
ALT	じ
ALU	す
ALV	ず
ALW	せ
ALX	ぜ
ALY	そ
ALZ	ぞ
AMA	た
AMB	だ
AMC	ち
AMD	ぢ
AME	っ
AMF	つ
AMG	づ
AMH	て
AMI	で
AMJ	と
AMK	ど
AML	な
AMM	に
AMN	ぬ
AMO	ね
AMP	の
AMQ	は
AMR	ば
AMS	ぱ
AMT	ひ
AMU	び
AMV	ぴ
AMW	ふ
AMX	ぶ
AMY	ぷ
AMZ	へ
ANA	べ
ANB	ぺ
ANC	ほ
AND	ぼ
ANE	ぽ
ANF	ま
ANG	み
ANH	む
ANI	め
ANJ	も
ANK	ゃ
ANL	や
ANM	ゅ
ANN	ゆ
ANO	ょ
ANP	よ
ANQ	ら
ANR	り
ANS	る
ANT	れ
ANU	ろ
ANV	ゎ
ANW	わ
ANX	ゐ
ANY	ゑ
ANZ	を
AOA	ん
AOB	 
AOC	 
AOD	 
AOE	 
AOF	 
AOG	 
AOH	 
AOI	 
AOJ	 
AOK	 
AOL	 
AOM	ァ
AON	ア
AOO	ィ
AOP	イ
AOQ	ゥ
AOR	ウ
AOS	ェ
AOT	エ
AOU	ォ
AOV	オ
AOW	カ
AOX	ガ
AOY	キ
AOZ	ギ
APA	ク
APB	グ
APC	ケ
APD	ゲ
APE	コ
APF	ゴ
APG	サ
APH	ザ
API	シ
APJ	ジ
APK	ス
APL	ズ
APM	セ
APN	ゼ
APO	ソ
APP	ゾ
APQ	タ
APR	ダ
APS	チ
APT	ヂ
APU	ッ
APV	ツ
APW	ヅ
APX	テ
APY	デ
APZ	ト
AQA	ド
AQB	ナ
AQC	ニ
AQD	ヌ
AQE	ネ
AQF	ノ
AQG	ハ
AQH	バ
AQI	パ
AQJ	ヒ
AQK	ビ
AQL	ピ
AQM	フ
AQN	ブ
AQO	プ
AQP	ヘ
AQQ	ベ
AQR	ペ
AQS	ホ
AQT	ボ
AQU	ポ
AQV	マ
AQW	ミ
AQX	ム
AQY	メ
AQZ	モ
ARA	ャ
ARB	ヤ
ARC	ュ
ARD	ユ
ARE	ョ
ARF	ヨ
ARG	ラ
ARH	リ
ARI	ル
ARJ	レ
ARK	ロ
ARL	ヮ
ARM	ワ
ARN	ヰ
ARO	ヱ
ARP	ヲ
ARQ	ン
ARR	ヴ
ARS	ヵ
ART	ヶ
ARU	 
ARV	 
ARW	 
ARX	 
ARY	 
ARZ	 
ASA	 
ASB	 
ASC	Α
ASD	Β
ASE	Γ
ASF	Δ
ASG	Ε
ASH	Ζ
ASI	Η
ASJ	Θ
ASK	Ι
ASL	Κ
ASM	Λ
ASN	Μ
ASO	Ν
ASP	Ξ
ASQ	Ο
ASR	Π
ASS	Ρ
AST	Σ
ASU	Τ
ASV	Υ
ASW	Φ
ASX	Χ
ASY	Ψ
ASZ	Ω
ATA	 
ATB	 
ATC	 
ATD	 
ATE	 
ATF	 
ATG	 
ATH	 
ATI	α
ATJ	β
ATK	γ
ATL	δ
ATM	ε
ATN	ζ
ATO	η
ATP	θ
ATQ	ι
ATR	κ
ATS	λ
ATT	μ
ATU	ν
ATV	ξ
ATW	ο
ATX	π
ATY	ρ
ATZ	σ
AUA	τ
AUB	υ
AUC	φ
AUD	χ
AUE	ψ
AUF	ω
AUG	 
AUH	 
AUI	 
AUJ	 
AUK	 
AUL	 
AUM	 
AUN	︵
AUO	︶
AUP	︹
AUQ	︺
AUR	︿
AUS	﹀
AUT	︽
AUU	︾
AUV	﹁
AUW	﹂
AUX	﹃
AUY	﹄
AUZ	 
AVA	 
AVB	︻
AVC	︼
AVD	︷
AVE	︸
AVF	︱
AVG	 
AVH	 
AVI	 
AVJ	 
AVK	 
AVL	 
AVM	 
AVN	 
AVO	 
AVP	 
AVQ	 
AVR	 
AVS	А
AVT	Б
AVU	В
AVV	Г
AVW	Д
AVX	Е
AVY	Ё
AVZ	Ж
AWA	З
AWB	И
AWC	Й
AWD	К
AWE	Л
AWF	М
AWG	Н
AWH	О
AWI	П
AWJ	Р
AWK	С
AWL	Т
AWM	У
AWN	Ф
AWO	Х
AWP	Ц
AWQ	Ч
AWR	Ш
AWS	Щ
AWT	Ъ
AWU	Ы
AWV	Ь
AWW	Э
AWX	Ю
AWY	Я
AWZ	 
AXA	 
AXB	 
AXC	 
AXD	 
AXE	 
AXF	 
AXG	 
AXH	 
AXI	 
AXJ	 
AXK	 
AXL	 
AXM	 
AXN	 
AXO	а
AXP	б
AXQ	в
AXR	г
AXS	д
AXT	е
AXU	ё
AXV	ж
AXW	з
AXX	и
AXY	й
AXZ	к
AYA	л
AYB	м
AYC	н
AYD	о
AYE	п
AYF	р
AYG	с
AYH	т
AYI	у
AYJ	ф
AYK	х
AYL	ц
AYM	ч
AYN	ш
AYO	щ
AYP	ъ
AYQ	ы
AYR	ь
AYS	э
AYT	ю
AYU	я
AYV	 
AYW	 
AYX	 
AYY	 
AYZ	 
AZA	 
AZB	 
AZC	 
AZD	 
AZE	 
AZF	 
AZG	 
AZH	 
AZI	ā
AZJ	á
AZK	ǎ
AZL	à
AZM	ē
AZN	é
AZO	ě
AZP	è
AZQ	ī
AZR	í
AZS	ǐ
AZT	ì
AZU	ō
AZV	ó
AZW	ǒ
AZX	ò
AZY	ū
AZZ	ú
BAA	ǔ
BAB	ù
BAC	ǖ
BAD	ǘ
BAE	ǚ
BAF	ǜ
BAG	ü
BAH	ê
BAI	ɑ
BAJ	ñ
BAK	ń
BAL	ň
BAM	ǹ
BAN	ɡ
BAO	 
BAP	 
BAQ	 
BAR	 
BAS	ㄅ
BAT	ㄆ
BAU	ㄇ
BAV	ㄈ
BAW	ㄉ
BAX	ㄊ
BAY	ㄋ
BAZ	ㄌ
BBA	ㄍ
BBB	ㄎ
BBC	ㄏ
BBD	ㄐ
BBE	ㄑ
BBF	ㄒ
BBG	ㄓ
BBH	ㄔ
BBI	ㄕ
BBJ	ㄖ
BBK	ㄗ
BBL	ㄘ
BBM	ㄙ
BBN	ㄚ
BBO	ㄛ
BBP	ㄜ
BBQ	ㄝ
BBR	ㄞ
BBS	ㄟ
BBT	ㄠ
BBU	ㄡ
BBV	ㄢ
BBW	ㄣ
BBX	ㄤ
BBY	ㄥ
BBZ	ㄦ
BCA	ㄧ
BCB	ㄨ
BCC	ㄩ
BCD	 
BCE	 
BCF	 
BCG	 
BCH	 
BCI	 
BCJ	 
BCK	 
BCL	 
BCM	 
BCN	 
BCO	 
BCP	 
BCQ	 
BCR	 
BCS	 
BCT	 
BCU	 
BCV	 
BCW	 
BCX	 
BCY	 
BCZ	 
BDA	 
BDB	─
BDC	━
BDD	│
BDE	┃
BDF	┄
BDG	┅
BDH	┆
BDI	┇
BDJ	┈
BDK	┉
BDL	┊
BDM	┋
BDN	┌
BDO	┍
BDP	┎
BDQ	┏
BDR	┐
BDS	┑
BDT	┒
BDU	┓
BDV	└
BDW	┕
BDX	┖
BDY	┗
BDZ	┘
BEA	┙
BEB	┚
BEC	┛
BED	├
BEE	┝
BEF	┞
BEG	┟
BEH	┠
BEI	┡
BEJ	┢
BEK	┣
BEL	┤
BEM	┥
BEN	┦
BEO	┧
BEP	┨
BEQ	┩
BER	┪
BES	┫
BET	┬
BEU	┭
BEV	┮
BEW	┯
BEX	┰
BEY	┱
BEZ	┲
BFA	┳
BFB	┴
BFC	┵
BFD	┶
BFE	┷
BFF	┸
BFG	┹
BFH	┺
BFI	┻
BFJ	┼
BFK	┽
BFL	┾
BFM	┿
BFN	╀
BFO	╁
BFP	╂
BFQ	╃
BFR	╄
BFS	╅
BFT	╆
BFU	╇
BFV	╈
BFW	╉
BFX	╊
BFY	╋
BFZ	 
BGA	 
BGB	 
BGC	 
BGD	 
BGE	 
BGF	 
BGG	 
BGH	 
BGI	 
BGJ	 
BGK	 
BGL	 
BGM	 
BGN	 
BGO	 
BGP	 
BGQ	 
BGR	 
BGS	 
BGT	 
BGU	 
BGV	 
BGW	 
BGX	 
BGY	 
BGZ	 
BHA	 
BHB	 
BHC	 
BHD	 
BHE	 
BHF	 
BHG	 
BHH	 
BHI	 
BHJ	 
BHK	 
BHL	 
BHM	 
BHN	 
BHO	 
BHP	 
BHQ	 
BHR	 
BHS	 
BHT	 
BHU	 
BHV	 
BHW	 
BHX	 
BHY	 
BHZ	 
BIA	 
BIB	 
BIC	 
BID	 
BIE	 
BIF	 
BIG	 
BIH	 
BII	 
BIJ	 
BIK	 
BIL	 
BIM	 
BIN	 
BIO	 
BIP	 
BIQ	 
BIR	 
BIS	 
BIT	 
BIU	 
BIV	 
BIW	 
BIX	 
BIY	 
BIZ	 
BJA	 
BJB	 
BJC	 
BJD	 
BJE	 
BJF	 
BJG	 
BJH	 
BJI	 
BJJ	 
BJK	 
BJL	 
BJM	 
BJN	 
BJO	 
BJP	 
BJQ	 
BJR	 
BJS	 
BJT	 
BJU	 
BJV	 
BJW	 
BJX	 
BJY	 
BJZ	 
BKA	 
BKB	 
BKC	 
BKD	 
BKE	 
BKF	 
BKG	 
BKH	 
BKI	 
BKJ	 
BKK	 
BKL	 
BKM	 
BKN	 
BKO	 
BKP	 
BKQ	 
BKR	 
BKS	 
BKT	 
BKU	 
BKV	 
BKW	 
BKX	 
BKY	 
BKZ	 
BLA	 
BLB	 
BLC	 
BLD	 
BLE	 
BLF	 
BLG	 
BLH	 
BLI	 
BLJ	 
BLK	 
BLL	 
BLM	 
BLN	 
BLO	 
BLP	 
BLQ	 
BLR	 
BLS	 
BLT	 
BLU	 
BLV	 
BLW	 
BLX	 
BLY	 
BLZ	 
BMA	 
BMB	 
BMC	 
BMD	 
BME	 
BMF	 
BMG	 
BMH	 
BMI	 
BMJ	 
BMK	 
BML	 
BMM	 
BMN	 
BMO	 
BMP	 
BMQ	 
BMR	 
BMS	 
BMT	 
BMU	 
BMV	 
BMW	 
BMX	 
BMY	 
BMZ	 
BNA	 
BNB	 
BNC	 
BND	 
BNE	 
BNF	 
BNG	 
BNH	 
BNI	 
BNJ	 
BNK	 
BNL	 
BNM	 
BNN	 
BNO	 
BNP	 
BNQ	 
BNR	 
BNS	 
BNT	 
BNU	 
BNV	 
BNW	 
BNX	 
BNY	 
BNZ	 
BOA	 
BOB	 
BOC	 
BOD	 
BOE	 
BOF	 
BOG	 
BOH	 
BOI	 
BOJ	 
BOK	 
BOL	 
BOM	 
BON	 
BOO	 
BOP	 
BOQ	 
BOR	 
BOS	 
BOT	 
BOU	 
BOV	 
BOW	 
BOX	 
BOY	 
BOZ	 
BPA	 
BPB	 
BPC	 
BPD	 
BPE	 
BPF	 
BPG	 
BPH	 
BPI	 
BPJ	 
BPK	 
BPL	 
BPM	 
BPN	 
BPO	 
BPP	 
BPQ	 
BPR	 
BPS	 
BPT	 
BPU	 
BPV	 
BPW	 
BPX	 
BPY	 
BPZ	 
BQA	 
BQB	 
BQC	 
BQD	 
BQE	 
BQF	 
BQG	 
BQH	 
BQI	 
BQJ	 
BQK	 
BQL	 
BQM	 
BQN	 
BQO	 
BQP	 
BQQ	 
BQR	 
BQS	 
BQT	 
BQU	 
BQV	 
BQW	 
BQX	 
BQY	 
BQZ	 
BRA	 
BRB	 
BRC	 
BRD	 
BRE	 
BRF	 
BRG	 
BRH	 
BRI	 
BRJ	 
BRK	 
BRL	 
BRM	 
BRN	 
BRO	 
BRP	 
BRQ	 
BRR	 
BRS	 
BRT	 
BRU	 
BRV	 
BRW	 
BRX	 
BRY	 
BRZ	 
BSA	 
BSB	 
BSC	 
BSD	 
BSE	 
BSF	 
BSG	 
BSH	 
BSI	 
BSJ	 
BSK	 
BSL	 
BSM	 
BSN	 
BSO	 
BSP	 
BSQ	 
BSR	 
BSS	 
BST	 
BSU	 
BSV	 
BSW	 
BSX	 
BSY	 
BSZ	 
BTA	 
BTB	 
BTC	 
BTD	 
BTE	 
BTF	 
BTG	 
BTH	 
BTI	 
BTJ	 
BTK	 
BTL	 
BTM	 
BTN	 
BTO	 
BTP	 
BTQ	 
BTR	 
BTS	 
BTT	 
BTU	 
BTV	 
BTW	 
BTX	 
BTY	 
BTZ	 
BUA	 
BUB	 
BUC	 
BUD	 
BUE	 
BUF	 
BUG	 
BUH	 
BUI	 
BUJ	 
BUK	 
BUL	 
BUM	 
BUN	 
BUO	 
BUP	 
BUQ	 
BUR	 
BUS	 
BUT	 
BUU	 
BUV	 
BUW	 
BUX	 
BUY	 
BUZ	 
BVA	 
BVB	 
BVC	 
BVD	 
BVE	 
BVF	 
BVG	 
BVH	 
BVI	 
BVJ	 
BVK	 
BVL	 
BVM	 
BVN	 
BVO	 
BVP	 
BVQ	 
BVR	 
BVS	 
BVT	 
BVU	 
BVV	 
BVW	 
BVX	 
BVY	 
BVZ	 
BWA	 
BWB	 
BWC	 
BWD	 
BWE	 
BWF	 
BWG	 
BWH	 
BWI	 
BWJ	 
BWK	 
BWL	 
BWM	 
BWN	 
BWO	 
BWP	 
BWQ	 
BWR	 
BWS	 
BWT	 
BWU	 
BWV	 
BWW	 
BWX	 
BWY	 
BWZ	 
BXA	 
BXB	 
BXC	 
BXD	 
BXE	 
BXF	 
BXG	 
BXH	 
BXI	 
BXJ	 
BXK	 
BXL	 
BXM	 
BXN	 
BXO	 
BXP	 
BXQ	 
BXR	 
BXS	 
BXT	 
BXU	 
BXV	 
BXW	 
BXX	 
BXY	 
BXZ	 
BYA	 
BYB	 
BYC	 
BYD	 
BYE	 
BYF	 
BYG	 
BYH	 
BYI	 
BYJ	 
BYK	 
BYL	 
BYM	 
BYN	 
BYO	 
BYP	 
BYQ	 
BYR	 
BYS	 
BYT	 
BYU	 
BYV	 
BYW	 
BYX	 
BYY	 
BYZ	 
BZA	 
BZB	 
BZC	 
BZD	 
BZE	 
BZF	 
BZG	 
BZH	 
BZI	 
BZJ	 
BZK	 
BZL	 
BZM	 
BZN	 
BZO	 
BZP	 
BZQ	 
BZR	 
BZS	 
BZT	 
BZU	 
BZV	 
BZW	 
BZX	 
BZY	 
BZZ	 
CAA	 
CAB	 
CAC	 
CAD	 
CAE	 
CAF	 
CAG	 
CAH	 
CAI	 
CAJ	 
CAK	 
CAL	 
CAM	 
CAN	 
CAO	 
CAP	 
CAQ	 
CAR	 
CAS	 
CAT	 
CAU	 
CAV	 
CAW	 
CAX	 
CAY	 
CAZ	 
CBA	 
CBB	 
CBC	 
CBD	 
CBE	 
CBF	 
CBG	 
CBH	 
CBI	 
CBJ	 
CBK	 
CBL	 
CBM	 
CBN	 
CBO	 
CBP	 
CBQ	 
CBR	 
CBS	 
CBT	 
CBU	 
CBV	 
CBW	 
CBX	 
CBY	 
CBZ	 
CCA	 
CCB	 
CCC	 
CCD	 
CCE	 
CCF	 
CCG	啊
CCH	阿
CCI	埃
CCJ	挨
CCK	哎
CCL	唉
CCM	哀
CCN	皑
CCO	癌
CCP	蔼
CCQ	矮
CCR	艾
CCS	碍
CCT	爱
CCU	隘
CCV	鞍
CCW	氨
CCX	安
CCY	俺
CCZ	按
CDA	暗
CDB	岸
CDC	胺
CDD	案
CDE	肮
CDF	昂
CDG	盎
CDH	凹
CDI	敖
CDJ	熬
CDK	翱
CDL	袄
CDM	傲
CDN	奥
CDO	懊
CDP	澳
CDQ	芭
CDR	捌
CDS	扒
CDT	叭
CDU	吧
CDV	笆
CDW	八
CDX	疤
CDY	巴
CDZ	拔
CEA	跋
CEB	靶
CEC	把
CED	耙
CEE	坝
CEF	霸
CEG	罢
CEH	爸
CEI	白
CEJ	柏
CEK	百
CEL	摆
CEM	佰
CEN	败
CEO	拜
CEP	稗
CEQ	斑
CER	班
CES	搬
CET	扳
CEU	般
CEV	颁
CEW	板
CEX	版
CEY	扮
CEZ	拌
CFA	伴
CFB	瓣
CFC	半
CFD	办
CFE	绊
CFF	邦
CFG	帮
CFH	梆
CFI	榜
CFJ	膀
CFK	绑
CFL	棒
CFM	磅
CFN	蚌
CFO	镑
CFP	傍
CFQ	谤
CFR	苞
CFS	胞
CFT	包
CFU	褒
CFV	剥
CFW	薄
CFX	雹
CFY	保
CFZ	堡
CGA	饱
CGB	宝
CGC	抱
CGD	报
CGE	暴
CGF	豹
CGG	鲍
CGH	爆
CGI	杯
CGJ	碑
CGK	悲
CGL	卑
CGM	北
CGN	辈
CGO	背
CGP	贝
CGQ	钡
CGR	倍
CGS	狈
CGT	备
CGU	惫
CGV	焙
CGW	被
CGX	奔
CGY	苯
CGZ	本
CHA	笨
CHB	崩
CHC	绷
CHD	甭
CHE	泵
CHF	蹦
CHG	迸
CHH	逼
CHI	鼻
CHJ	比
CHK	鄙
CHL	笔
CHM	彼
CHN	碧
CHO	蓖
CHP	蔽
CHQ	毕
CHR	毙
CHS	毖
CHT	币
CHU	庇
CHV	痹
CHW	闭
CHX	敝
CHY	弊
CHZ	必
CIA	辟
CIB	壁
CIC	臂
CID	避
CIE	陛
CIF	鞭
CIG	边
CIH	编
CII	贬
CIJ	扁
CIK	便
CIL	变
CIM	卞
CIN	辨
CIO	辩
CIP	辫
CIQ	遍
CIR	标
CIS	彪
CIT	膘
CIU	表
CIV	鳖
CIW	憋
CIX	别
CIY	瘪
CIZ	彬
CJA	斌
CJB	濒
CJC	滨
CJD	宾
CJE	摈
CJF	兵
CJG	冰
CJH	柄
CJI	丙
CJJ	秉
CJK	饼
CJL	炳
CJM	病
CJN	并
CJO	玻
CJP	菠
CJQ	播
CJR	拨
CJS	钵
CJT	波
CJU	博
CJV	勃
CJW	搏
CJX	铂
CJY	箔
CJZ	伯
CKA	帛
CKB	舶
CKC	脖
CKD	膊
CKE	渤
CKF	泊
CKG	驳
CKH	捕
CKI	卜
CKJ	哺
CKK	补
CKL	埠
CKM	不
CKN	布
CKO	步
CKP	簿
CKQ	部
CKR	怖
CKS	擦
CKT	猜
CKU	裁
CKV	材
CKW	才
CKX	财
CKY	睬
CKZ	踩
CLA	采
CLB	彩
CLC	菜
CLD	蔡
CLE	餐
CLF	参
CLG	蚕
CLH	残
CLI	惭
CLJ	惨
CLK	灿
CLL	苍
CLM	舱
CLN	仓
CLO	沧
CLP	藏
CLQ	操
CLR	糙
CLS	槽
CLT	曹
CLU	草
CLV	厕
CLW	策
CLX	侧
CLY	册
CLZ	测
CMA	层
CMB	蹭
CMC	插
CMD	叉
CME	茬
CMF	茶
CMG	查
CMH	碴
CMI	搽
CMJ	察
CMK	岔
CML	差
CMM	诧
CMN	拆
CMO	柴
CMP	豺
CMQ	搀
CMR	掺
CMS	蝉
CMT	馋
CMU	谗
CMV	缠
CMW	铲
CMX	产
CMY	阐
CMZ	颤
CNA	昌
CNB	猖
CNC	场
CND	尝
CNE	常
CNF	长
CNG	偿
CNH	肠
CNI	厂
CNJ	敞
CNK	畅
CNL	唱
CNM	倡
CNN	超
CNO	抄
CNP	钞
CNQ	朝
CNR	嘲
CNS	潮
CNT	巢
CNU	吵
CNV	炒
CNW	车
CNX	扯
CNY	撤
CNZ	掣
COA	彻
COB	澈
COC	郴
COD	臣
COE	辰
COF	尘
COG	晨
COH	忱
COI	沉
COJ	陈
COK	趁
COL	衬
COM	撑
CON	称
COO	城
COP	橙
COQ	成
COR	呈
COS	乘
COT	程
COU	惩
COV	澄
COW	诚
COX	承
COY	逞
COZ	骋
CPA	秤
CPB	吃
CPC	痴
CPD	持
CPE	匙
CPF	池
CPG	迟
CPH	弛
CPI	驰
CPJ	耻
CPK	齿
CPL	侈
CPM	尺
CPN	赤
CPO	翅
CPP	斥
CPQ	炽
CPR	充
CPS	冲
CPT	虫
CPU	崇
CPV	宠
CPW	抽
CPX	酬
CPY	畴
CPZ	踌
CQA	稠
CQB	愁
CQC	筹
CQD	仇
CQE	绸
CQF	瞅
CQG	丑
CQH	臭
CQI	初
CQJ	出
CQK	橱
CQL	厨
CQM	躇
CQN	锄
CQO	雏
CQP	滁
CQQ	除
CQR	楚
CQS	础
CQT	储
CQU	矗
CQV	搐
CQW	触
CQX	处
CQY	揣
CQZ	川
CRA	穿
CRB	椽
CRC	传
CRD	船
CRE	喘
CRF	串
CRG	疮
CRH	窗
CRI	幢
CRJ	床
CRK	闯
CRL	创
CRM	吹
CRN	炊
CRO	捶
CRP	锤
CRQ	垂
CRR	春
CRS	椿
CRT	醇
CRU	唇
CRV	淳
CRW	纯
CRX	蠢
CRY	戳
CRZ	绰
CSA	疵
CSB	茨
CSC	磁
CSD	雌
CSE	辞
CSF	慈
CSG	瓷
CSH	词
CSI	此
CSJ	刺
CSK	赐
CSL	次
CSM	聪
CSN	葱
CSO	囱
CSP	匆
CSQ	从
CSR	丛
CSS	凑
CST	粗
CSU	醋
CSV	簇
CSW	促
CSX	蹿
CSY	篡
CSZ	窜
CTA	摧
CTB	崔
CTC	催
CTD	脆
CTE	瘁
CTF	粹
CTG	淬
CTH	翠
CTI	村
CTJ	存
CTK	寸
CTL	磋
CTM	撮
CTN	搓
CTO	措
CTP	挫
CTQ	错
CTR	搭
CTS	达
CTT	答
CTU	瘩
CTV	打
CTW	大
CTX	呆
CTY	歹
CTZ	傣
CUA	戴
CUB	带
CUC	殆
CUD	代
CUE	贷
CUF	袋
CUG	待
CUH	逮
CUI	怠
CUJ	耽
CUK	担
CUL	丹
CUM	单
CUN	郸
CUO	掸
CUP	胆
CUQ	旦
CUR	氮
CUS	但
CUT	惮
CUU	淡
CUV	诞
CUW	弹
CUX	蛋
CUY	当
CUZ	挡
CVA	党
CVB	荡
CVC	档
CVD	刀
CVE	捣
CVF	蹈
CVG	倒
CVH	岛
CVI	祷
CVJ	导
CVK	到
CVL	稻
CVM	悼
CVN	道
CVO	盗
CVP	德
CVQ	得
CVR	的
CVS	蹬
CVT	灯
CVU	登
CVV	等
CVW	瞪
CVX	凳
CVY	邓
CVZ	堤
CWA	低
CWB	滴
CWC	迪
CWD	敌
CWE	笛
CWF	狄
CWG	涤
CWH	翟
CWI	嫡
CWJ	抵
CWK	底
CWL	地
CWM	蒂
CWN	第
CWO	帝
CWP	弟
CWQ	递
CWR	缔
CWS	颠
CWT	掂
CWU	滇
CWV	碘
CWW	点
CWX	典
CWY	靛
CWZ	垫
CXA	电
CXB	佃
CXC	甸
CXD	店
CXE	惦
CXF	奠
CXG	淀
CXH	殿
CXI	碉
CXJ	叼
CXK	雕
CXL	凋
CXM	刁
CXN	掉
CXO	吊
CXP	钓
CXQ	调
CXR	跌
CXS	爹
CXT	碟
CXU	蝶
CXV	迭
CXW	谍
CXX	叠
CXY	丁
CXZ	盯
CYA	叮
CYB	钉
CYC	顶
CYD	鼎
CYE	锭
CYF	定
CYG	订
CYH	丢
CYI	东
CYJ	冬
CYK	董
CYL	懂
CYM	动
CYN	栋
CYO	侗
CYP	恫
CYQ	冻
CYR	洞
CYS	兜
CYT	抖
CYU	斗
CYV	陡
CYW	豆
CYX	逗
CYY	痘
CYZ	都
CZA	督
CZB	毒
CZC	犊
CZD	独
CZE	读
CZF	堵
CZG	睹
CZH	赌
CZI	杜
CZJ	镀
CZK	肚
CZL	度
CZM	渡
CZN	妒
CZO	端
CZP	短
CZQ	锻
CZR	段
CZS	断
CZT	缎
CZU	堆
CZV	兑
CZW	队
CZX	对
CZY	墩
CZZ	吨
DAA	蹲
DAB	敦
DAC	顿
DAD	囤
DAE	钝
DAF	盾
DAG	遁
DAH	掇
DAI	哆
DAJ	多
DAK	夺
DAL	垛
DAM	躲
DAN	朵
DAO	跺
DAP	舵
DAQ	剁
DAR	惰
DAS	堕
DAT	蛾
DAU	峨
DAV	鹅
DAW	俄
DAX	额
DAY	讹
DAZ	娥
DBA	恶
DBB	厄
DBC	扼
DBD	遏
DBE	鄂
DBF	饿
DBG	恩
DBH	而
DBI	儿
DBJ	耳
DBK	尔
DBL	饵
DBM	洱
DBN	二
DBO	贰
DBP	发
DBQ	罚
DBR	筏
DBS	伐
DBT	乏
DBU	阀
DBV	法
DBW	珐
DBX	藩
DBY	帆
DBZ	番
DCA	翻
DCB	樊
DCC	矾
DCD	钒
DCE	繁
DCF	凡
DCG	烦
DCH	反
DCI	返
DCJ	范
DCK	贩
DCL	犯
DCM	饭
DCN	泛
DCO	坊
DCP	芳
DCQ	方
DCR	肪
DCS	房
DCT	防
DCU	妨
DCV	仿
DCW	访
DCX	纺
DCY	放
DCZ	菲
DDA	非
DDB	啡
DDC	飞
DDD	肥
DDE	匪
DDF	诽
DDG	吠
DDH	肺
DDI	废
DDJ	沸
DDK	费
DDL	芬
DDM	酚
DDN	吩
DDO	氛
DDP	分
DDQ	纷
DDR	坟
DDS	焚
DDT	汾
DDU	粉
DDV	奋
DDW	份
DDX	忿
DDY	愤
DDZ	粪
DEA	丰
DEB	封
DEC	枫
DED	蜂
DEE	峰
DEF	锋
DEG	风
DEH	疯
DEI	烽
DEJ	逢
DEK	冯
DEL	缝
DEM	讽
DEN	奉
DEO	凤
DEP	佛
DEQ	否
DER	夫
DES	敷
DET	肤
DEU	孵
DEV	扶
DEW	拂
DEX	辐
DEY	幅
DEZ	氟
DFA	符
DFB	伏
DFC	俘
DFD	服
DFE	浮
DFF	涪
DFG	福
DFH	袱
DFI	弗
DFJ	甫
DFK	抚
DFL	辅
DFM	俯
DFN	釜
DFO	斧
DFP	脯
DFQ	腑
DFR	府
DFS	腐
DFT	赴
DFU	副
DFV	覆
DFW	赋
DFX	复
DFY	傅
DFZ	付
DGA	阜
DGB	父
DGC	腹
DGD	负
DGE	富
DGF	讣
DGG	附
DGH	妇
DGI	缚
DGJ	咐
DGK	噶
DGL	嘎
DGM	该
DGN	改
DGO	概
DGP	钙
DGQ	盖
DGR	溉
DGS	干
DGT	甘
DGU	杆
DGV	柑
DGW	竿
DGX	肝
DGY	赶
DGZ	感
DHA	秆
DHB	敢
DHC	赣
DHD	冈
DHE	刚
DHF	钢
DHG	缸
DHH	肛
DHI	纲
DHJ	岗
DHK	港
DHL	杠
DHM	篙
DHN	皋
DHO	高
DHP	膏
DHQ	羔
DHR	糕
DHS	搞
DHT	镐
DHU	稿
DHV	告
DHW	哥
DHX	歌
DHY	搁
DHZ	戈
DIA	鸽
DIB	胳
DIC	疙
DID	割
DIE	革
DIF	葛
DIG	格
DIH	蛤
DII	阁
DIJ	隔
DIK	铬
DIL	个
DIM	各
DIN	给
DIO	根
DIP	跟
DIQ	耕
DIR	更
DIS	庚
DIT	羹
DIU	埂
DIV	耿
DIW	梗
DIX	工
DIY	攻
DIZ	功
DJA	恭
DJB	龚
DJC	供
DJD	躬
DJE	公
DJF	宫
DJG	弓
DJH	巩
DJI	汞
DJJ	拱
DJK	贡
DJL	共
DJM	钩
DJN	勾
DJO	沟
DJP	苟
DJQ	狗
DJR	垢
DJS	构
DJT	购
DJU	够
DJV	辜
DJW	菇
DJX	咕
DJY	箍
DJZ	估
DKA	沽
DKB	孤
DKC	姑
DKD	鼓
DKE	古
DKF	蛊
DKG	骨
DKH	谷
DKI	股
DKJ	故
DKK	顾
DKL	固
DKM	雇
DKN	刮
DKO	瓜
DKP	剐
DKQ	寡
DKR	挂
DKS	褂
DKT	乖
DKU	拐
DKV	怪
DKW	棺
DKX	关
DKY	官
DKZ	冠
DLA	观
DLB	管
DLC	馆
DLD	罐
DLE	惯
DLF	灌
DLG	贯
DLH	光
DLI	广
DLJ	逛
DLK	瑰
DLL	规
DLM	圭
DLN	硅
DLO	归
DLP	龟
DLQ	闺
DLR	轨
DLS	鬼
DLT	诡
DLU	癸
DLV	桂
DLW	柜
DLX	跪
DLY	贵
DLZ	刽
DMA	辊
DMB	滚
DMC	棍
DMD	锅
DME	郭
DMF	国
DMG	果
DMH	裹
DMI	过
DMJ	哈
DMK	骸
DML	孩
DMM	海
DMN	氦
DMO	亥
DMP	害
DMQ	骇
DMR	酣
DMS	憨
DMT	邯
DMU	韩
DMV	含
DMW	涵
DMX	寒
DMY	函
DMZ	喊
DNA	罕
DNB	翰
DNC	撼
DND	捍
DNE	旱
DNF	憾
DNG	悍
DNH	焊
DNI	汗
DNJ	汉
DNK	夯
DNL	杭
DNM	航
DNN	壕
DNO	嚎
DNP	豪
DNQ	毫
DNR	郝
DNS	好
DNT	耗
DNU	号
DNV	浩
DNW	呵
DNX	喝
DNY	荷
DNZ	菏
DOA	核
DOB	禾
DOC	和
DOD	何
DOE	合
DOF	盒
DOG	貉
DOH	阂
DOI	河
DOJ	涸
DOK	赫
DOL	褐
DOM	鹤
DON	贺
DOO	嘿
DOP	黑
DOQ	痕
DOR	很
DOS	狠
DOT	恨
DOU	哼
DOV	亨
DOW	横
DOX	衡
DOY	恒
DOZ	轰
DPA	哄
DPB	烘
DPC	虹
DPD	鸿
DPE	洪
DPF	宏
DPG	弘
DPH	红
DPI	喉
DPJ	侯
DPK	猴
DPL	吼
DPM	厚
DPN	候
DPO	后
DPP	呼
DPQ	乎
DPR	忽
DPS	瑚
DPT	壶
DPU	葫
DPV	胡
DPW	蝴
DPX	狐
DPY	糊
DPZ	湖
DQA	弧
DQB	虎
DQC	唬
DQD	护
DQE	互
DQF	沪
DQG	户
DQH	花
DQI	哗
DQJ	华
DQK	猾
DQL	滑
DQM	画
DQN	划
DQO	化
DQP	话
DQQ	槐
DQR	徊
DQS	怀
DQT	淮
DQU	坏
DQV	欢
DQW	环
DQX	桓
DQY	还
DQZ	缓
DRA	换
DRB	患
DRC	唤
DRD	痪
DRE	豢
DRF	焕
DRG	涣
DRH	宦
DRI	幻
DRJ	荒
DRK	慌
DRL	黄
DRM	磺
DRN	蝗
DRO	簧
DRP	皇
DRQ	凰
DRR	惶
DRS	煌
DRT	晃
DRU	幌
DRV	恍
DRW	谎
DRX	灰
DRY	挥
DRZ	辉
DSA	徽
DSB	恢
DSC	蛔
DSD	回
DSE	毁
DSF	悔
DSG	慧
DSH	卉
DSI	惠
DSJ	晦
DSK	贿
DSL	秽
DSM	会
DSN	烩
DSO	汇
DSP	讳
DSQ	诲
DSR	绘
DSS	荤
DST	昏
DSU	婚
DSV	魂
DSW	浑
DSX	混
DSY	豁
DSZ	活
DTA	伙
DTB	火
DTC	获
DTD	或
DTE	惑
DTF	霍
DTG	货
DTH	祸
DTI	击
DTJ	圾
DTK	基
DTL	机
DTM	畸
DTN	稽
DTO	积
DTP	箕
DTQ	肌
DTR	饥
DTS	迹
DTT	激
DTU	讥
DTV	鸡
DTW	姬
DTX	绩
DTY	缉
DTZ	吉
DUA	极
DUB	棘
DUC	辑
DUD	籍
DUE	集
DUF	及
DUG	急
DUH	疾
DUI	汲
DUJ	即
DUK	嫉
DUL	级
DUM	挤
DUN	几
DUO	脊
DUP	己
DUQ	蓟
DUR	技
DUS	冀
DUT	季
DUU	伎
DUV	祭
DUW	剂
DUX	悸
DUY	济
DUZ	寄
DVA	寂
DVB	计
DVC	记
DVD	既
DVE	忌
DVF	际
DVG	妓
DVH	继
DVI	纪
DVJ	嘉
DVK	枷
DVL	夹
DVM	佳
DVN	家
DVO	加
DVP	荚
DVQ	颊
DVR	贾
DVS	甲
DVT	钾
DVU	假
DVV	稼
DVW	价
DVX	架
DVY	驾
DVZ	嫁
DWA	歼
DWB	监
DWC	坚
DWD	尖
DWE	笺
DWF	间
DWG	煎
DWH	兼
DWI	肩
DWJ	艰
DWK	奸
DWL	缄
DWM	茧
DWN	检
DWO	柬
DWP	碱
DWQ	硷
DWR	拣
DWS	捡
DWT	简
DWU	俭
DWV	剪
DWW	减
DWX	荐
DWY	槛
DWZ	鉴
DXA	践
DXB	贱
DXC	见
DXD	键
DXE	箭
DXF	件
DXG	健
DXH	舰
DXI	剑
DXJ	饯
DXK	渐
DXL	溅
DXM	涧
DXN	建
DXO	僵
DXP	姜
DXQ	将
DXR	浆
DXS	江
DXT	疆
DXU	蒋
DXV	桨
DXW	奖
DXX	讲
DXY	匠
DXZ	酱
DYA	降
DYB	蕉
DYC	椒
DYD	礁
DYE	焦
DYF	胶
DYG	交
DYH	郊
DYI	浇
DYJ	骄
DYK	娇
DYL	嚼
DYM	搅
DYN	铰
DYO	矫
DYP	侥
DYQ	脚
DYR	狡
DYS	角
DYT	饺
DYU	缴
DYV	绞
DYW	剿
DYX	教
DYY	酵
DYZ	轿
DZA	较
DZB	叫
DZC	窖
DZD	揭
DZE	接
DZF	皆
DZG	秸
DZH	街
DZI	阶
DZJ	截
DZK	劫
DZL	节
DZM	桔
DZN	杰
DZO	捷
DZP	睫
DZQ	竭
DZR	洁
DZS	结
DZT	解
DZU	姐
DZV	戒
DZW	藉
DZX	芥
DZY	界
DZZ	借
EAA	介
EAB	疥
EAC	诫
EAD	届
EAE	巾
EAF	筋
EAG	斤
EAH	金
EAI	今
EAJ	津
EAK	襟
EAL	紧
EAM	锦
EAN	仅
EAO	谨
EAP	进
EAQ	靳
EAR	晋
EAS	禁
EAT	近
EAU	烬
EAV	浸
EAW	尽
EAX	劲
EAY	荆
EAZ	兢
EBA	茎
EBB	睛
EBC	晶
EBD	鲸
EBE	京
EBF	惊
EBG	精
EBH	粳
EBI	经
EBJ	井
EBK	警
EBL	景
EBM	颈
EBN	静
EBO	境
EBP	敬
EBQ	镜
EBR	径
EBS	痉
EBT	靖
EBU	竟
EBV	竞
EBW	净
EBX	炯
EBY	窘
EBZ	揪
ECA	究
ECB	纠
ECC	玖
ECD	韭
ECE	久
ECF	灸
ECG	九
ECH	酒
ECI	厩
ECJ	救
ECK	旧
ECL	臼
ECM	舅
ECN	咎
ECO	就
ECP	疚
ECQ	鞠
ECR	拘
ECS	狙
ECT	疽
ECU	居
ECV	驹
ECW	菊
ECX	局
ECY	咀
ECZ	矩
EDA	举
EDB	沮
EDC	聚
EDD	拒
EDE	据
EDF	巨
EDG	具
EDH	距
EDI	踞
EDJ	锯
EDK	俱
EDL	句
EDM	惧
EDN	炬
EDO	剧
EDP	捐
EDQ	鹃
EDR	娟
EDS	倦
EDT	眷
EDU	卷
EDV	绢
EDW	撅
EDX	攫
EDY	抉
EDZ	掘
EEA	倔
EEB	爵
EEC	觉
EED	决
EEE	诀
EEF	绝
EEG	均
EEH	菌
EEI	钧
EEJ	军
EEK	君
EEL	峻
EEM	俊
EEN	竣
EEO	浚
EEP	郡
EEQ	骏
EER	喀
EES	咖
EET	卡
EEU	咯
EEV	开
EEW	揩
EEX	楷
EEY	凯
EEZ	慨
EFA	刊
EFB	堪
EFC	勘
EFD	坎
EFE	砍
EFF	看
EFG	康
EFH	慷
EFI	糠
EFJ	扛
EFK	抗
EFL	亢
EFM	炕
EFN	考
EFO	拷
EFP	烤
EFQ	靠
EFR	坷
EFS	苛
EFT	柯
EFU	棵
EFV	磕
EFW	颗
EFX	科
EFY	壳
EFZ	咳
EGA	可
EGB	渴
EGC	克
EGD	刻
EGE	客
EGF	课
EGG	肯
EGH	啃
EGI	垦
EGJ	恳
EGK	坑
EGL	吭
EGM	空
EGN	恐
EGO	孔
EGP	控
EGQ	抠
EGR	口
EGS	扣
EGT	寇
EGU	枯
EGV	哭
EGW	窟
EGX	苦
EGY	酷
EGZ	库
EHA	裤
EHB	夸
EHC	垮
EHD	挎
EHE	跨
EHF	胯
EHG	块
EHH	筷
EHI	侩
EHJ	快
EHK	宽
EHL	款
EHM	匡
EHN	筐
EHO	狂
EHP	框
EHQ	矿
EHR	眶
EHS	旷
EHT	况
EHU	亏
EHV	盔
EHW	岿
EHX	窥
EHY	葵
EHZ	奎
EIA	魁
EIB	傀
EIC	馈
EID	愧
EIE	溃
EIF	坤
EIG	昆
EIH	捆
EII	困
EIJ	括
EIK	扩
EIL	廓
EIM	阔
EIN	垃
EIO	拉
EIP	喇
EIQ	蜡
EIR	腊
EIS	辣
EIT	啦
EIU	莱
EIV	来
EIW	赖
EIX	蓝
EIY	婪
EIZ	栏
EJA	拦
EJB	篮
EJC	阑
EJD	兰
EJE	澜
EJF	谰
EJG	揽
EJH	览
EJI	懒
EJJ	缆
EJK	烂
EJL	滥
EJM	琅
EJN	榔
EJO	狼
EJP	廊
EJQ	郎
EJR	朗
EJS	浪
EJT	捞
EJU	劳
EJV	牢
EJW	老
EJX	佬
EJY	姥
EJZ	酪
EKA	烙
EKB	涝
EKC	勒
EKD	乐
EKE	雷
EKF	镭
EKG	蕾
EKH	磊
EKI	累
EKJ	儡
EKK	垒
EKL	擂
EKM	肋
EKN	类
EKO	泪
EKP	棱
EKQ	楞
EKR	冷
EKS	厘
EKT	梨
EKU	犁
EKV	黎
EKW	篱
EKX	狸
EKY	离
EKZ	漓
ELA	理
ELB	李
ELC	里
ELD	鲤
ELE	礼
ELF	莉
ELG	荔
ELH	吏
ELI	栗
ELJ	丽
ELK	厉
ELL	励
ELM	砾
ELN	历
ELO	利
ELP	傈
ELQ	例
ELR	俐
ELS	痢
ELT	立
ELU	粒
ELV	沥
ELW	隶
ELX	力
ELY	璃
ELZ	哩
EMA	俩
EMB	联
EMC	莲
EMD	连
EME	镰
EMF	廉
EMG	怜
EMH	涟
EMI	帘
EMJ	敛
EMK	脸
EML	链
EMM	恋
EMN	炼
EMO	练
EMP	粮
EMQ	凉
EMR	梁
EMS	粱
EMT	良
EMU	两
EMV	辆
EMW	量
EMX	晾
EMY	亮
EMZ	谅
ENA	撩
ENB	聊
ENC	僚
END	疗
ENE	燎
ENF	寥
ENG	辽
ENH	潦
ENI	了
ENJ	撂
ENK	镣
ENL	廖
ENM	料
ENN	列
ENO	裂
ENP	烈
ENQ	劣
ENR	猎
ENS	琳
ENT	林
ENU	磷
ENV	霖
ENW	临
ENX	邻
ENY	鳞
ENZ	淋
EOA	凛
EOB	赁
EOC	吝
EOD	拎
EOE	玲
EOF	菱
EOG	零
EOH	龄
EOI	铃
EOJ	伶
EOK	羚
EOL	凌
EOM	灵
EON	陵
EOO	岭
EOP	领
EOQ	另
EOR	令
EOS	溜
EOT	琉
EOU	榴
EOV	硫
EOW	馏
EOX	留
EOY	刘
EOZ	瘤
EPA	流
EPB	柳
EPC	六
EPD	龙
EPE	聋
EPF	咙
EPG	笼
EPH	窿
EPI	隆
EPJ	垄
EPK	拢
EPL	陇
EPM	楼
EPN	娄
EPO	搂
EPP	篓
EPQ	漏
EPR	陋
EPS	芦
EPT	卢
EPU	颅
EPV	庐
EPW	炉
EPX	掳
EPY	卤
EPZ	虏
EQA	鲁
EQB	麓
EQC	碌
EQD	露
EQE	路
EQF	赂
EQG	鹿
EQH	潞
EQI	禄
EQJ	录
EQK	陆
EQL	戮
EQM	驴
EQN	吕
EQO	铝
EQP	侣
EQQ	旅
EQR	履
EQS	屡
EQT	缕
EQU	虑
EQV	氯
EQW	律
EQX	率
EQY	滤
EQZ	绿
ERA	峦
ERB	挛
ERC	孪
ERD	滦
ERE	卵
ERF	乱
ERG	掠
ERH	略
ERI	抡
ERJ	轮
ERK	伦
ERL	仑
ERM	沦
ERN	纶
ERO	论
ERP	萝
ERQ	螺
ERR	罗
ERS	逻
ERT	锣
ERU	箩
ERV	骡
ERW	裸
ERX	落
ERY	洛
ERZ	骆
ESA	络
ESB	妈
ESC	麻
ESD	玛
ESE	码
ESF	蚂
ESG	马
ESH	骂
ESI	嘛
ESJ	吗
ESK	埋
ESL	买
ESM	麦
ESN	卖
ESO	迈
ESP	脉
ESQ	瞒
ESR	馒
ESS	蛮
EST	满
ESU	蔓
ESV	曼
ESW	慢
ESX	漫
ESY	谩
ESZ	芒
ETA	茫
ETB	盲
ETC	氓
ETD	忙
ETE	莽
ETF	猫
ETG	茅
ETH	锚
ETI	毛
ETJ	矛
ETK	铆
ETL	卯
ETM	茂
ETN	冒
ETO	帽
ETP	貌
ETQ	贸
ETR	么
ETS	玫
ETT	枚
ETU	梅
ETV	酶
ETW	霉
ETX	煤
ETY	没
ETZ	眉
EUA	媒
EUB	镁
EUC	每
EUD	美
EUE	昧
EUF	寐
EUG	妹
EUH	媚
EUI	门
EUJ	闷
EUK	们
EUL	萌
EUM	蒙
EUN	檬
EUO	盟
EUP	锰
EUQ	猛
EUR	梦
EUS	孟
EUT	眯
EUU	醚
EUV	靡
EUW	糜
EUX	迷
EUY	谜
EUZ	弥
EVA	米
EVB	秘
EVC	觅
EVD	泌
EVE	蜜
EVF	密
EVG	幂
EVH	棉
EVI	眠
EVJ	绵
EVK	冕
EVL	免
EVM	勉
EVN	娩
EVO	缅
EVP	面
EVQ	苗
EVR	描
EVS	瞄
EVT	藐
EVU	秒
EVV	渺
EVW	庙
EVX	妙
EVY	蔑
EVZ	灭
EWA	民
EWB	抿
EWC	皿
EWD	敏
EWE	悯
EWF	闽
EWG	明
EWH	螟
EWI	鸣
EWJ	铭
EWK	名
EWL	命
EWM	谬
EWN	摸
EWO	摹
EWP	蘑
EWQ	模
EWR	膜
EWS	磨
EWT	摩
EWU	魔
EWV	抹
EWW	末
EWX	莫
EWY	墨
EWZ	默
EXA	沫
EXB	漠
EXC	寞
EXD	陌
EXE	谋
EXF	牟
EXG	某
EXH	拇
EXI	牡
EXJ	亩
EXK	姆
EXL	母
EXM	墓
EXN	暮
EXO	幕
EXP	募
EXQ	慕
EXR	木
EXS	目
EXT	睦
EXU	牧
EXV	穆
EXW	拿
EXX	哪
EXY	呐
EXZ	钠
EYA	那
EYB	娜
EYC	纳
EYD	氖
EYE	乃
EYF	奶
EYG	耐
EYH	奈
EYI	南
EYJ	男
EYK	难
EYL	囊
EYM	挠
EYN	脑
EYO	恼
EYP	闹
EYQ	淖
EYR	呢
EYS	馁
EYT	内
EYU	嫩
EYV	能
EYW	妮
EYX	霓
EYY	倪
EYZ	泥
EZA	尼
EZB	拟
EZC	你
EZD	匿
EZE	腻
EZF	逆
EZG	溺
EZH	蔫
EZI	拈
EZJ	年
EZK	碾
EZL	撵
EZM	捻
EZN	念
EZO	娘
EZP	酿
EZQ	鸟
EZR	尿
EZS	捏
EZT	聂
EZU	孽
EZV	啮
EZW	镊
EZX	镍
EZY	涅
EZZ	您
FAA	柠
FAB	狞
FAC	凝
FAD	宁
FAE	拧
FAF	泞
FAG	牛
FAH	扭
FAI	钮
FAJ	纽
FAK	脓
FAL	浓
FAM	农
FAN	弄
FAO	奴
FAP	努
FAQ	怒
FAR	女
FAS	暖
FAT	虐
FAU	疟
FAV	挪
FAW	懦
FAX	糯
FAY	诺
FAZ	哦
FBA	欧
FBB	鸥
FBC	殴
FBD	藕
FBE	呕
FBF	偶
FBG	沤
FBH	啪
FBI	趴
FBJ	爬
FBK	帕
FBL	怕
FBM	琶
FBN	拍
FBO	排
FBP	牌
FBQ	徘
FBR	湃
FBS	派
FBT	攀
FBU	潘
FBV	盘
FBW	磐
FBX	盼
FBY	畔
FBZ	判
FCA	叛
FCB	乓
FCC	庞
FCD	旁
FCE	耪
FCF	胖
FCG	抛
FCH	咆
FCI	刨
FCJ	炮
FCK	袍
FCL	跑
FCM	泡
FCN	呸
FCO	胚
FCP	培
FCQ	裴
FCR	赔
FCS	陪
FCT	配
FCU	佩
FCV	沛
FCW	喷
FCX	盆
FCY	砰
FCZ	抨
FDA	烹
FDB	澎
FDC	彭
FDD	蓬
FDE	棚
FDF	硼
FDG	篷
FDH	膨
FDI	朋
FDJ	鹏
FDK	捧
FDL	碰
FDM	坯
FDN	砒
FDO	霹
FDP	批
FDQ	披
FDR	劈
FDS	琵
FDT	毗
FDU	啤
FDV	脾
FDW	疲
FDX	皮
FDY	匹
FDZ	痞
FEA	僻
FEB	屁
FEC	譬
FED	篇
FEE	偏
FEF	片
FEG	骗
FEH	飘
FEI	漂
FEJ	瓢
FEK	票
FEL	撇
FEM	瞥
FEN	拼
FEO	频
FEP	贫
FEQ	品
FER	聘
FES	乒
FET	坪
FEU	苹
FEV	萍
FEW	平
FEX	凭
FEY	瓶
FEZ	评
FFA	屏
FFB	坡
FFC	泼
FFD	颇
FFE	婆
FFF	破
FFG	魄
FFH	迫
FFI	粕
FFJ	剖
FFK	扑
FFL	铺
FFM	仆
FFN	莆
FFO	葡
FFP	菩
FFQ	蒲
FFR	埔
FFS	朴
FFT	圃
FFU	普
FFV	浦
FFW	谱
FFX	曝
FFY	瀑
FFZ	期
FGA	欺
FGB	栖
FGC	戚
FGD	妻
FGE	七
FGF	凄
FGG	漆
FGH	柒
FGI	沏
FGJ	其
FGK	棋
FGL	奇
FGM	歧
FGN	畦
FGO	崎
FGP	脐
FGQ	齐
FGR	旗
FGS	祈
FGT	祁
FGU	骑
FGV	起
FGW	岂
FGX	乞
FGY	企
FGZ	启
FHA	契
FHB	砌
FHC	器
FHD	气
FHE	迄
FHF	弃
FHG	汽
FHH	泣
FHI	讫
FHJ	掐
FHK	恰
FHL	洽
FHM	牵
FHN	扦
FHO	钎
FHP	铅
FHQ	千
FHR	迁
FHS	签
FHT	仟
FHU	谦
FHV	乾
FHW	黔
FHX	钱
FHY	钳
FHZ	前
FIA	潜
FIB	遣
FIC	浅
FID	谴
FIE	堑
FIF	嵌
FIG	欠
FIH	歉
FII	枪
FIJ	呛
FIK	腔
FIL	羌
FIM	墙
FIN	蔷
FIO	强
FIP	抢
FIQ	橇
FIR	锹
FIS	敲
FIT	悄
FIU	桥
FIV	瞧
FIW	乔
FIX	侨
FIY	巧
FIZ	鞘
FJA	撬
FJB	翘
FJC	峭
FJD	俏
FJE	窍
FJF	切
FJG	茄
FJH	且
FJI	怯
FJJ	窃
FJK	钦
FJL	侵
FJM	亲
FJN	秦
FJO	琴
FJP	勤
FJQ	芹
FJR	擒
FJS	禽
FJT	寝
FJU	沁
FJV	青
FJW	轻
FJX	氢
FJY	倾
FJZ	卿
FKA	清
FKB	擎
FKC	晴
FKD	氰
FKE	情
FKF	顷
FKG	请
FKH	庆
FKI	琼
FKJ	穷
FKK	秋
FKL	丘
FKM	邱
FKN	球
FKO	求
FKP	囚
FKQ	酋
FKR	泅
FKS	趋
FKT	区
FKU	蛆
FKV	曲
FKW	躯
FKX	屈
FKY	驱
FKZ	渠
FLA	取
FLB	娶
FLC	龋
FLD	趣
FLE	去
FLF	圈
FLG	颧
FLH	权
FLI	醛
FLJ	泉
FLK	全
FLL	痊
FLM	拳
FLN	犬
FLO	券
FLP	劝
FLQ	缺
FLR	炔
FLS	瘸
FLT	却
FLU	鹊
FLV	榷
FLW	确
FLX	雀
FLY	裙
FLZ	群
FMA	然
FMB	燃
FMC	冉
FMD	染
FME	瓤
FMF	壤
FMG	攘
FMH	嚷
FMI	让
FMJ	饶
FMK	扰
FML	绕
FMM	惹
FMN	热
FMO	壬
FMP	仁
FMQ	人
FMR	忍
FMS	韧
FMT	任
FMU	认
FMV	刃
FMW	妊
FMX	纫
FMY	扔
FMZ	仍
FNA	日
FNB	戎
FNC	茸
FND	蓉
FNE	荣
FNF	融
FNG	熔
FNH	溶
FNI	容
FNJ	绒
FNK	冗
FNL	揉
FNM	柔
FNN	肉
FNO	茹
FNP	蠕
FNQ	儒
FNR	孺
FNS	如
FNT	辱
FNU	乳
FNV	汝
FNW	入
FNX	褥
FNY	软
FNZ	阮
FOA	蕊
FOB	瑞
FOC	锐
FOD	闰
FOE	润
FOF	若
FOG	弱
FOH	撒
FOI	洒
FOJ	萨
FOK	腮
FOL	鳃
FOM	塞
FON	赛
FOO	三
FOP	叁
FOQ	伞
FOR	散
FOS	桑
FOT	嗓
FOU	丧
FOV	搔
FOW	骚
FOX	扫
FOY	嫂
FOZ	瑟
FPA	色
FPB	涩
FPC	森
FPD	僧
FPE	莎
FPF	砂
FPG	杀
FPH	刹
FPI	沙
FPJ	纱
FPK	傻
FPL	啥
FPM	煞
FPN	筛
FPO	晒
FPP	珊
FPQ	苫
FPR	杉
FPS	山
FPT	删
FPU	煽
FPV	衫
FPW	闪
FPX	陕
FPY	擅
FPZ	赡
FQA	膳
FQB	善
FQC	汕
FQD	扇
FQE	缮
FQF	墒
FQG	伤
FQH	商
FQI	赏
FQJ	晌
FQK	上
FQL	尚
FQM	裳
FQN	梢
FQO	捎
FQP	稍
FQQ	烧
FQR	芍
FQS	勺
FQT	韶
FQU	少
FQV	哨
FQW	邵
FQX	绍
FQY	奢
FQZ	赊
FRA	蛇
FRB	舌
FRC	舍
FRD	赦
FRE	摄
FRF	射
FRG	慑
FRH	涉
FRI	社
FRJ	设
FRK	砷
FRL	申
FRM	呻
FRN	伸
FRO	身
FRP	深
FRQ	娠
FRR	绅
FRS	神
FRT	沈
FRU	审
FRV	婶
FRW	甚
FRX	肾
FRY	慎
FRZ	渗
FSA	声
FSB	生
FSC	甥
FSD	牲
FSE	升
FSF	绳
FSG	省
FSH	盛
FSI	剩
FSJ	胜
FSK	圣
FSL	师
FSM	失
FSN	狮
FSO	施
FSP	湿
FSQ	诗
FSR	尸
FSS	虱
FST	十
FSU	石
FSV	拾
FSW	时
FSX	什
FSY	食
FSZ	蚀
FTA	实
FTB	识
FTC	史
FTD	矢
FTE	使
FTF	屎
FTG	驶
FTH	始
FTI	式
FTJ	示
FTK	士
FTL	世
FTM	柿
FTN	事
FTO	拭
FTP	誓
FTQ	逝
FTR	势
FTS	是
FTT	嗜
FTU	噬
FTV	适
FTW	仕
FTX	侍
FTY	释
FTZ	饰
FUA	氏
FUB	市
FUC	恃
FUD	室
FUE	视
FUF	试
FUG	收
FUH	手
FUI	首
FUJ	守
FUK	寿
FUL	授
FUM	售
FUN	受
FUO	瘦
FUP	兽
FUQ	蔬
FUR	枢
FUS	梳
FUT	殊
FUU	抒
FUV	输
FUW	叔
FUX	舒
FUY	淑
FUZ	疏
FVA	书
FVB	赎
FVC	孰
FVD	熟
FVE	薯
FVF	暑
FVG	曙
FVH	署
FVI	蜀
FVJ	黍
FVK	鼠
FVL	属
FVM	术
FVN	述
FVO	树
FVP	束
FVQ	戍
FVR	竖
FVS	墅
FVT	庶
FVU	数
FVV	漱
FVW	恕
FVX	刷
FVY	耍
FVZ	摔
FWA	衰
FWB	甩
FWC	帅
FWD	栓
FWE	拴
FWF	霜
FWG	双
FWH	爽
FWI	谁
FWJ	水
FWK	睡
FWL	税
FWM	吮
FWN	瞬
FWO	顺
FWP	舜
FWQ	说
FWR	硕
FWS	朔
FWT	烁
FWU	斯
FWV	撕
FWW	嘶
FWX	思
FWY	私
FWZ	司
FXA	丝
FXB	死
FXC	肆
FXD	寺
FXE	嗣
FXF	四
FXG	伺
FXH	似
FXI	饲
FXJ	巳
FXK	松
FXL	耸
FXM	怂
FXN	颂
FXO	送
FXP	宋
FXQ	讼
FXR	诵
FXS	搜
FXT	艘
FXU	擞
FXV	嗽
FXW	苏
FXX	酥
FXY	俗
FXZ	素
FYA	速
FYB	粟
FYC	僳
FYD	塑
FYE	溯
FYF	宿
FYG	诉
FYH	肃
FYI	酸
FYJ	蒜
FYK	算
FYL	虽
FYM	隋
FYN	随
FYO	绥
FYP	髓
FYQ	碎
FYR	岁
FYS	穗
FYT	遂
FYU	隧
FYV	祟
FYW	孙
FYX	损
FYY	笋
FYZ	蓑
FZA	梭
FZB	唆
FZC	缩
FZD	琐
FZE	索
FZF	锁
FZG	所
FZH	塌
FZI	他
FZJ	它
FZK	她
FZL	塔
FZM	獭
FZN	挞
FZO	蹋
FZP	踏
FZQ	胎
FZR	苔
FZS	抬
FZT	台
FZU	泰
FZV	酞
FZW	太
FZX	态
FZY	汰
FZZ	坍
GAA	摊
GAB	贪
GAC	瘫
GAD	滩
GAE	坛
GAF	檀
GAG	痰
GAH	潭
GAI	谭
GAJ	谈
GAK	坦
GAL	毯
GAM	袒
GAN	碳
GAO	探
GAP	叹
GAQ	炭
GAR	汤
GAS	塘
GAT	搪
GAU	堂
GAV	棠
GAW	膛
GAX	唐
GAY	糖
GAZ	倘
GBA	躺
GBB	淌
GBC	趟
GBD	烫
GBE	掏
GBF	涛
GBG	滔
GBH	绦
GBI	萄
GBJ	桃
GBK	逃
GBL	淘
GBM	陶
GBN	讨
GBO	套
GBP	特
GBQ	藤
GBR	腾
GBS	疼
GBT	誊
GBU	梯
GBV	剔
GBW	踢
GBX	锑
GBY	提
GBZ	题
GCA	蹄
GCB	啼
GCC	体
GCD	替
GCE	嚏
GCF	惕
GCG	涕
GCH	剃
GCI	屉
GCJ	天
GCK	添
GCL	填
GCM	田
GCN	甜
GCO	恬
GCP	舔
GCQ	腆
GCR	挑
GCS	条
GCT	迢
GCU	眺
GCV	跳
GCW	贴
GCX	铁
GCY	帖
GCZ	厅
GDA	听
GDB	烃
GDC	汀
GDD	廷
GDE	停
GDF	亭
GDG	庭
GDH	挺
GDI	艇
GDJ	通
GDK	桐
GDL	酮
GDM	瞳
GDN	同
GDO	铜
GDP	彤
GDQ	童
GDR	桶
GDS	捅
GDT	筒
GDU	统
GDV	痛
GDW	偷
GDX	投
GDY	头
GDZ	透
GEA	凸
GEB	秃
GEC	突
GED	图
GEE	徒
GEF	途
GEG	涂
GEH	屠
GEI	土
GEJ	吐
GEK	兔
GEL	湍
GEM	团
GEN	推
GEO	颓
GEP	腿
GEQ	蜕
GER	褪
GES	退
GET	吞
GEU	屯
GEV	臀
GEW	拖
GEX	托
GEY	脱
GEZ	鸵
GFA	陀
GFB	驮
GFC	驼
GFD	椭
GFE	妥
GFF	拓
GFG	唾
GFH	挖
GFI	哇
GFJ	蛙
GFK	洼
GFL	娃
GFM	瓦
GFN	袜
GFO	歪
GFP	外
GFQ	豌
GFR	弯
GFS	湾
GFT	玩
GFU	顽
GFV	丸
GFW	烷
GFX	完
GFY	碗
GFZ	挽
GGA	晚
GGB	皖
GGC	惋
GGD	宛
GGE	婉
GGF	万
GGG	腕
GGH	汪
GGI	王
GGJ	亡
GGK	枉
GGL	网
GGM	往
GGN	旺
GGO	望
GGP	忘
GGQ	妄
GGR	威
GGS	巍
GGT	微
GGU	危
GGV	韦
GGW	违
GGX	桅
GGY	围
GGZ	唯
GHA	惟
GHB	为
GHC	潍
GHD	维
GHE	苇
GHF	萎
GHG	委
GHH	伟
GHI	伪
GHJ	尾
GHK	纬
GHL	未
GHM	蔚
GHN	味
GHO	畏
GHP	胃
GHQ	喂
GHR	魏
GHS	位
GHT	渭
GHU	谓
GHV	尉
GHW	慰
GHX	卫
GHY	瘟
GHZ	温
GIA	蚊
GIB	文
GIC	闻
GID	纹
GIE	吻
GIF	稳
GIG	紊
GIH	问
GII	嗡
GIJ	翁
GIK	瓮
GIL	挝
GIM	蜗
GIN	涡
GIO	窝
GIP	我
GIQ	斡
GIR	卧
GIS	握
GIT	沃
GIU	巫
GIV	呜
GIW	钨
GIX	乌
GIY	污
GIZ	诬
GJA	屋
GJB	无
GJC	芜
GJD	梧
GJE	吾
GJF	吴
GJG	毋
GJH	武
GJI	五
GJJ	捂
GJK	午
GJL	舞
GJM	伍
GJN	侮
GJO	坞
GJP	戊
GJQ	雾
GJR	晤
GJS	物
GJT	勿
GJU	务
GJV	悟
GJW	误
GJX	昔
GJY	熙
GJZ	析
GKA	西
GKB	硒
GKC	矽
GKD	晰
GKE	嘻
GKF	吸
GKG	锡
GKH	牺
GKI	稀
GKJ	息
GKK	希
GKL	悉
GKM	膝
GKN	夕
GKO	惜
GKP	熄
GKQ	烯
GKR	溪
GKS	汐
GKT	犀
GKU	檄
GKV	袭
GKW	席
GKX	习
GKY	媳
GKZ	喜
GLA	铣
GLB	洗
GLC	系
GLD	隙
GLE	戏
GLF	细
GLG	瞎
GLH	虾
GLI	匣
GLJ	霞
GLK	辖
GLL	暇
GLM	峡
GLN	侠
GLO	狭
GLP	下
GLQ	厦
GLR	夏
GLS	吓
GLT	掀
GLU	锨
GLV	先
GLW	仙
GLX	鲜
GLY	纤
GLZ	咸
GMA	贤
GMB	衔
GMC	舷
GMD	闲
GME	涎
GMF	弦
GMG	嫌
GMH	显
GMI	险
GMJ	现
GMK	献
GML	县
GMM	腺
GMN	馅
GMO	羡
GMP	宪
GMQ	陷
GMR	限
GMS	线
GMT	相
GMU	厢
GMV	镶
GMW	香
GMX	箱
GMY	襄
GMZ	湘
GNA	乡
GNB	翔
GNC	祥
GND	详
GNE	想
GNF	响
GNG	享
GNH	项
GNI	巷
GNJ	橡
GNK	像
GNL	向
GNM	象
GNN	萧
GNO	硝
GNP	霄
GNQ	削
GNR	哮
GNS	嚣
GNT	销
GNU	消
GNV	宵
GNW	淆
GNX	晓
GNY	小
GNZ	孝
GOA	校
GOB	肖
GOC	啸
GOD	笑
GOE	效
GOF	楔
GOG	些
GOH	歇
GOI	蝎
GOJ	鞋
GOK	协
GOL	挟
GOM	携
GON	邪
GOO	斜
GOP	胁
GOQ	谐
GOR	写
GOS	械
GOT	卸
GOU	蟹
GOV	懈
GOW	泄
GOX	泻
GOY	谢
GOZ	屑
GPA	薪
GPB	芯
GPC	锌
GPD	欣
GPE	辛
GPF	新
GPG	忻
GPH	心
GPI	信
GPJ	衅
GPK	星
GPL	腥
GPM	猩
GPN	惺
GPO	兴
GPP	刑
GPQ	型
GPR	形
GPS	邢
GPT	行
GPU	醒
GPV	幸
GPW	杏
GPX	性
GPY	姓
GPZ	兄
GQA	凶
GQB	胸
GQC	匈
GQD	汹
GQE	雄
GQF	熊
GQG	休
GQH	修
GQI	羞
GQJ	朽
GQK	嗅
GQL	锈
GQM	秀
GQN	袖
GQO	绣
GQP	墟
GQQ	戌
GQR	需
GQS	虚
GQT	嘘
GQU	须
GQV	徐
GQW	许
GQX	蓄
GQY	酗
GQZ	叙
GRA	旭
GRB	序
GRC	畜
GRD	恤
GRE	絮
GRF	婿
GRG	绪
GRH	续
GRI	轩
GRJ	喧
GRK	宣
GRL	悬
GRM	旋
GRN	玄
GRO	选
GRP	癣
GRQ	眩
GRR	绚
GRS	靴
GRT	薛
GRU	学
GRV	穴
GRW	雪
GRX	血
GRY	勋
GRZ	熏
GSA	循
GSB	旬
GSC	询
GSD	寻
GSE	驯
GSF	巡
GSG	殉
GSH	汛
GSI	训
GSJ	讯
GSK	逊
GSL	迅
GSM	压
GSN	押
GSO	鸦
GSP	鸭
GSQ	呀
GSR	丫
GSS	芽
GST	牙
GSU	蚜
GSV	崖
GSW	衙
GSX	涯
GSY	雅
GSZ	哑
GTA	亚
GTB	讶
GTC	焉
GTD	咽
GTE	阉
GTF	烟
GTG	淹
GTH	盐
GTI	严
GTJ	研
GTK	蜒
GTL	岩
GTM	延
GTN	言
GTO	颜
GTP	阎
GTQ	炎
GTR	沿
GTS	奄
GTT	掩
GTU	眼
GTV	衍
GTW	演
GTX	艳
GTY	堰
GTZ	燕
GUA	厌
GUB	砚
GUC	雁
GUD	唁
GUE	彦
GUF	焰
GUG	宴
GUH	谚
GUI	验
GUJ	殃
GUK	央
GUL	鸯
GUM	秧
GUN	杨
GUO	扬
GUP	佯
GUQ	疡
GUR	羊
GUS	洋
GUT	阳
GUU	氧
GUV	仰
GUW	痒
GUX	养
GUY	样
GUZ	漾
GVA	邀
GVB	腰
GVC	妖
GVD	瑶
GVE	摇
GVF	尧
GVG	遥
GVH	窑
GVI	谣
GVJ	姚
GVK	咬
GVL	舀
GVM	药
GVN	要
GVO	耀
GVP	椰
GVQ	噎
GVR	耶
GVS	爷
GVT	野
GVU	冶
GVV	也
GVW	页
GVX	掖
GVY	业
GVZ	叶
GWA	曳
GWB	腋
GWC	夜
GWD	液
GWE	一
GWF	壹
GWG	医
GWH	揖
GWI	铱
GWJ	依
GWK	伊
GWL	衣
GWM	颐
GWN	夷
GWO	遗
GWP	移
GWQ	仪
GWR	胰
GWS	疑
GWT	沂
GWU	宜
GWV	姨
GWW	彝
GWX	椅
GWY	蚁
GWZ	倚
GXA	已
GXB	乙
GXC	矣
GXD	以
GXE	艺
GXF	抑
GXG	易
GXH	邑
GXI	屹
GXJ	亿
GXK	役
GXL	臆
GXM	逸
GXN	肄
GXO	疫
GXP	亦
GXQ	裔
GXR	意
GXS	毅
GXT	忆
GXU	义
GXV	益
GXW	溢
GXX	诣
GXY	议
GXZ	谊
GYA	译
GYB	异
GYC	翼
GYD	翌
GYE	绎
GYF	茵
GYG	荫
GYH	因
GYI	殷
GYJ	音
GYK	阴
GYL	姻
GYM	吟
GYN	银
GYO	淫
GYP	寅
GYQ	饮
GYR	尹
GYS	引
GYT	隐
GYU	印
GYV	英
GYW	樱
GYX	婴
GYY	鹰
GYZ	应
GZA	缨
GZB	莹
GZC	萤
GZD	营
GZE	荧
GZF	蝇
GZG	迎
GZH	赢
GZI	盈
GZJ	影
GZK	颖
GZL	硬
GZM	映
GZN	哟
GZO	拥
GZP	佣
GZQ	臃
GZR	痈
GZS	庸
GZT	雍
GZU	踊
GZV	蛹
GZW	咏
GZX	泳
GZY	涌
GZZ	永
HAA	恿
HAB	勇
HAC	用
HAD	幽
HAE	优
HAF	悠
HAG	忧
HAH	尤
HAI	由
HAJ	邮
HAK	铀
HAL	犹
HAM	油
HAN	游
HAO	酉
HAP	有
HAQ	友
HAR	右
HAS	佑
HAT	釉
HAU	诱
HAV	又
HAW	幼
HAX	迂
HAY	淤
HAZ	于
HBA	盂
HBB	榆
HBC	虞
HBD	愚
HBE	舆
HBF	余
HBG	俞
HBH	逾
HBI	鱼
HBJ	愉
HBK	渝
HBL	渔
HBM	隅
HBN	予
HBO	娱
HBP	雨
HBQ	与
HBR	屿
HBS	禹
HBT	宇
HBU	语
HBV	羽
HBW	玉
HBX	域
HBY	芋
HBZ	郁
HCA	吁
HCB	遇
HCC	喻
HCD	峪
HCE	御
HCF	愈
HCG	欲
HCH	狱
HCI	育
HCJ	誉
HCK	浴
HCL	寓
HCM	裕
HCN	预
HCO	豫
HCP	驭
HCQ	鸳
HCR	渊
HCS	冤
HCT	元
HCU	垣
HCV	袁
HCW	原
HCX	援
HCY	辕
HCZ	园
HDA	员
HDB	圆
HDC	猿
HDD	源
HDE	缘
HDF	远
HDG	苑
HDH	愿
HDI	怨
HDJ	院
HDK	曰
HDL	约
HDM	越
HDN	跃
HDO	钥
HDP	岳
HDQ	粤
HDR	月
HDS	悦
HDT	阅
HDU	耘
HDV	云
HDW	郧
HDX	匀
HDY	陨
HDZ	允
HEA	运
HEB	蕴
HEC	酝
HED	晕
HEE	韵
HEF	孕
HEG	匝
HEH	砸
HEI	杂
HEJ	栽
HEK	哉
HEL	灾
HEM	宰
HEN	载
HEO	再
HEP	在
HEQ	咱
HER	攒
HES	暂
HET	赞
HEU	赃
HEV	脏
HEW	葬
HEX	遭
HEY	糟
HEZ	凿
HFA	藻
HFB	枣
HFC	早
HFD	澡
HFE	蚤
HFF	躁
HFG	噪
HFH	造
HFI	皂
HFJ	灶
HFK	燥
HFL	责
HFM	择
HFN	则
HFO	泽
HFP	贼
HFQ	怎
HFR	增
HFS	憎
HFT	曾
HFU	赠
HFV	扎
HFW	喳
HFX	渣
HFY	札
HFZ	轧
HGA	铡
HGB	闸
HGC	眨
HGD	栅
HGE	榨
HGF	咋
HGG	乍
HGH	炸
HGI	诈
HGJ	摘
HGK	斋
HGL	宅
HGM	窄
HGN	债
HGO	寨
HGP	瞻
HGQ	毡
HGR	詹
HGS	粘
HGT	沾
HGU	盏
HGV	斩
HGW	辗
HGX	崭
HGY	展
HGZ	蘸
HHA	栈
HHB	占
HHC	战
HHD	站
HHE	湛
HHF	绽
HHG	樟
HHH	章
HHI	彰
HHJ	漳
HHK	张
HHL	掌
HHM	涨
HHN	杖
HHO	丈
HHP	帐
HHQ	账
HHR	仗
HHS	胀
HHT	瘴
HHU	障
HHV	招
HHW	昭
HHX	找
HHY	沼
HHZ	赵
HIA	照
HIB	罩
HIC	兆
HID	肇
HIE	召
HIF	遮
HIG	折
HIH	哲
HII	蛰
HIJ	辙
HIK	者
HIL	锗
HIM	蔗
HIN	这
HIO	浙
HIP	珍
HIQ	斟
HIR	真
HIS	甄
HIT	砧
HIU	臻
HIV	贞
HIW	针
HIX	侦
HIY	枕
HIZ	疹
HJA	诊
HJB	震
HJC	振
HJD	镇
HJE	阵
HJF	蒸
HJG	挣
HJH	睁
HJI	征
HJJ	狰
HJK	争
HJL	怔
HJM	整
HJN	拯
HJO	正
HJP	政
HJQ	帧
HJR	症
HJS	郑
HJT	证
HJU	芝
HJV	枝
HJW	支
HJX	吱
HJY	蜘
HJZ	知
HKA	肢
HKB	脂
HKC	汁
HKD	之
HKE	织
HKF	职
HKG	直
HKH	植
HKI	殖
HKJ	执
HKK	值
HKL	侄
HKM	址
HKN	指
HKO	止
HKP	趾
HKQ	只
HKR	旨
HKS	纸
HKT	志
HKU	挚
HKV	掷
HKW	至
HKX	致
HKY	置
HKZ	帜
HLA	峙
HLB	制
HLC	智
HLD	秩
HLE	稚
HLF	质
HLG	炙
HLH	痔
HLI	滞
HLJ	治
HLK	窒
HLL	中
HLM	盅
HLN	忠
HLO	钟
HLP	衷
HLQ	终
HLR	种
HLS	肿
HLT	重
HLU	仲
HLV	众
HLW	舟
HLX	周
HLY	州
HLZ	洲
HMA	诌
HMB	粥
HMC	轴
HMD	肘
HME	帚
HMF	咒
HMG	皱
HMH	宙
HMI	昼
HMJ	骤
HMK	珠
HML	株
HMM	蛛
HMN	朱
HMO	猪
HMP	诸
HMQ	诛
HMR	逐
HMS	竹
HMT	烛
HMU	煮
HMV	拄
HMW	瞩
HMX	嘱
HMY	主
HMZ	著
HNA	柱
HNB	助
HNC	蛀
HND	贮
HNE	铸
HNF	筑
HNG	住
HNH	注
HNI	祝
HNJ	驻
HNK	抓
HNL	爪
HNM	拽
HNN	专
HNO	砖
HNP	转
HNQ	撰
HNR	赚
HNS	篆
HNT	桩
HNU	庄
HNV	装
HNW	妆
HNX	撞
HNY	壮
HNZ	状
HOA	椎
HOB	锥
HOC	追
HOD	赘
HOE	坠
HOF	缀
HOG	谆
HOH	准
HOI	捉
HOJ	拙
HOK	卓
HOL	桌
HOM	琢
HON	茁
HOO	酌
HOP	啄
HOQ	着
HOR	灼
HOS	浊
HOT	兹
HOU	咨
HOV	资
HOW	姿
HOX	滋
HOY	淄
HOZ	孜
HPA	紫
HPB	仔
HPC	籽
HPD	滓
HPE	子
HPF	自
HPG	渍
HPH	字
HPI	鬃
HPJ	棕
HPK	踪
HPL	宗
HPM	综
HPN	总
HPO	纵
HPP	邹
HPQ	走
HPR	奏
HPS	揍
HPT	租
HPU	足
HPV	卒
HPW	族
HPX	祖
HPY	诅
HPZ	阻
HQA	组
HQB	钻
HQC	纂
HQD	嘴
HQE	醉
HQF	最
HQG	罪
HQH	尊
HQI	遵
HQJ	昨
HQK	左
HQL	佐
HQM	柞
HQN	做
HQO	作
HQP	坐
HQQ	座
HQR	 
HQS	 
HQT	 
HQU	 
HQV	 
HQW	亍
HQX	丌
HQY	兀
HQZ	丐
HRA	廿
HRB	卅
HRC	丕
HRD	亘
HRE	丞
HRF	鬲
HRG	孬
HRH	噩
HRI	丨
HRJ	禺
HRK	丿
HRL	匕
HRM	乇
HRN	夭
HRO	爻
HRP	卮
HRQ	氐
HRR	囟
HRS	胤
HRT	馗
HRU	毓
HRV	睾
HRW	鼗
HRX	丶
HRY	亟
HRZ	鼐
HSA	乜
HSB	乩
HSC	亓
HSD	芈
HSE	孛
HSF	啬
HSG	嘏
HSH	仄
HSI	厍
HSJ	厝
HSK	厣
HSL	厥
HSM	厮
HSN	靥
HSO	赝
HSP	匚
HSQ	叵
HSR	匦
HSS	匮
HST	匾
HSU	赜
HSV	卦
HSW	卣
HSX	刂
HSY	刈
HSZ	刎
HTA	刭
HTB	刳
HTC	刿
HTD	剀
HTE	剌
HTF	剞
HTG	剡
HTH	剜
HTI	蒯
HTJ	剽
HTK	劂
HTL	劁
HTM	劐
HTN	劓
HTO	冂
HTP	罔
HTQ	亻
HTR	仃
HTS	仉
HTT	仂
HTU	仨
HTV	仡
HTW	仫
HTX	仞
HTY	伛
HTZ	仳
HUA	伢
HUB	佤
HUC	仵
HUD	伥
HUE	伧
HUF	伉
HUG	伫
HUH	佞
HUI	佧
HUJ	攸
HUK	佚
HUL	佝
HUM	佟
HUN	佗
HUO	伲
HUP	伽
HUQ	佶
HUR	佴
HUS	侑
HUT	侉
HUU	侃
HUV	侏
HUW	佾
HUX	佻
HUY	侪
HUZ	佼
HVA	侬
HVB	侔
HVC	俦
HVD	俨
HVE	俪
HVF	俅
HVG	俚
HVH	俣
HVI	俜
HVJ	俑
HVK	俟
HVL	俸
HVM	倩
HVN	偌
HVO	俳
HVP	倬
HVQ	倏
HVR	倮
HVS	倭
HVT	俾
HVU	倜
HVV	倌
HVW	倥
HVX	倨
HVY	偾
HVZ	偃
HWA	偕
HWB	偈
HWC	偎
HWD	偬
HWE	偻
HWF	傥
HWG	傧
HWH	傩
HWI	傺
HWJ	僖
HWK	儆
HWL	僭
HWM	僬
HWN	僦
HWO	僮
HWP	儇
HWQ	儋
HWR	仝
HWS	氽
HWT	佘
HWU	佥
HWV	俎
HWW	龠
HWX	汆
HWY	籴
HWZ	兮
HXA	巽
HXB	黉
HXC	馘
HXD	冁
HXE	夔
HXF	勹
HXG	匍
HXH	訇
HXI	匐
HXJ	凫
HXK	夙
HXL	兕
HXM	亠
HXN	兖
HXO	亳
HXP	衮
HXQ	袤
HXR	亵
HXS	脔
HXT	裒
HXU	禀
HXV	嬴
HXW	蠃
HXX	羸
HXY	冫
HXZ	冱
HYA	冽
HYB	冼
HYC	凇
HYD	冖
HYE	冢
HYF	冥
HYG	讠
HYH	讦
HYI	讧
HYJ	讪
HYK	讴
HYL	讵
HYM	讷
HYN	诂
HYO	诃
HYP	诋
HYQ	诏
HYR	诎
HYS	诒
HYT	诓
HYU	诔
HYV	诖
HYW	诘
HYX	诙
HYY	诜
HYZ	诟
HZA	诠
HZB	诤
HZC	诨
HZD	诩
HZE	诮
HZF	诰
HZG	诳
HZH	诶
HZI	诹
HZJ	诼
HZK	诿
HZL	谀
HZM	谂
HZN	谄
HZO	谇
HZP	谌
HZQ	谏
HZR	谑
HZS	谒
HZT	谔
HZU	谕
HZV	谖
HZW	谙
HZX	谛
HZY	谘
HZZ	谝
IAA	谟
IAB	谠
IAC	谡
IAD	谥
IAE	谧
IAF	谪
IAG	谫
IAH	谮
IAI	谯
IAJ	谲
IAK	谳
IAL	谵
IAM	谶
IAN	卩
IAO	卺
IAP	阝
IAQ	阢
IAR	阡
IAS	阱
IAT	阪
IAU	阽
IAV	阼
IAW	陂
IAX	陉
IAY	陔
IAZ	陟
IBA	陧
IBB	陬
IBC	陲
IBD	陴
IBE	隈
IBF	隍
IBG	隗
IBH	隰
IBI	邗
IBJ	邛
IBK	邝
IBL	邙
IBM	邬
IBN	邡
IBO	邴
IBP	邳
IBQ	邶
IBR	邺
IBS	邸
IBT	邰
IBU	郏
IBV	郅
IBW	邾
IBX	郐
IBY	郄
IBZ	郇
ICA	郓
ICB	郦
ICC	郢
ICD	郜
ICE	郗
ICF	郛
ICG	郫
ICH	郯
ICI	郾
ICJ	鄄
ICK	鄢
ICL	鄞
ICM	鄣
ICN	鄱
ICO	鄯
ICP	鄹
ICQ	酃
ICR	酆
ICS	刍
ICT	奂
ICU	劢
ICV	劬
ICW	劭
ICX	劾
ICY	哿
ICZ	勐
IDA	勖
IDB	勰
IDC	叟
IDD	燮
IDE	矍
IDF	廴
IDG	凵
IDH	凼
IDI	鬯
IDJ	厶
IDK	弁
IDL	畚
IDM	巯
IDN	坌
IDO	垩
IDP	垡
IDQ	塾
IDR	墼
IDS	壅
IDT	壑
IDU	圩
IDV	圬
IDW	圪
IDX	圳
IDY	圹
IDZ	圮
IEA	圯
IEB	坜
IEC	圻
IED	坂
IEE	坩
IEF	垅
IEG	坫
IEH	垆
IEI	坼
IEJ	坻
IEK	坨
IEL	坭
IEM	坶
IEN	坳
IEO	垭
IEP	垤
IEQ	垌
IER	垲
IES	埏
IET	垧
IEU	垴
IEV	垓
IEW	垠
IEX	埕
IEY	埘
IEZ	埚
IFA	埙
IFB	埒
IFC	垸
IFD	埴
IFE	埯
IFF	埸
IFG	埤
IFH	埝
IFI	堋
IFJ	堍
IFK	埽
IFL	埭
IFM	堀
IFN	堞
IFO	堙
IFP	塄
IFQ	堠
IFR	塥
IFS	塬
IFT	墁
IFU	墉
IFV	墚
IFW	墀
IFX	馨
IFY	鼙
IFZ	懿
IGA	艹
IGB	艽
IGC	艿
IGD	芏
IGE	芊
IGF	芨
IGG	芄
IGH	芎
IGI	芑
IGJ	芗
IGK	芙
IGL	芫
IGM	芸
IGN	芾
IGO	芰
IGP	苈
IGQ	苊
IGR	苣
IGS	芘
IGT	芷
IGU	芮
IGV	苋
IGW	苌
IGX	苁
IGY	芩
IGZ	芴
IHA	芡
IHB	芪
IHC	芟
IHD	苄
IHE	苎
IHF	芤
IHG	苡
IHH	茉
IHI	苷
IHJ	苤
IHK	茏
IHL	茇
IHM	苜
IHN	苴
IHO	苒
IHP	苘
IHQ	茌
IHR	苻
IHS	苓
IHT	茑
IHU	茚
IHV	茆
IHW	茔
IHX	茕
IHY	苠
IHZ	苕
IIA	茜
IIB	荑
IIC	荛
IID	荜
IIE	茈
IIF	莒
IIG	茼
IIH	茴
III	茱
IIJ	莛
IIK	荞
IIL	茯
IIM	荏
IIN	荇
IIO	荃
IIP	荟
IIQ	荀
IIR	茗
IIS	荠
IIT	茭
IIU	茺
IIV	茳
IIW	荦
IIX	荥
IIY	荨
IIZ	茛
IJA	荩
IJB	荬
IJC	荪
IJD	荭
IJE	荮
IJF	莰
IJG	荸
IJH	莳
IJI	莴
IJJ	莠
IJK	莪
IJL	莓
IJM	莜
IJN	莅
IJO	荼
IJP	莶
IJQ	莩
IJR	荽
IJS	莸
IJT	荻
IJU	莘
IJV	莞
IJW	莨
IJX	莺
IJY	莼
IJZ	菁
IKA	萁
IKB	菥
IKC	菘
IKD	堇
IKE	萘
IKF	萋
IKG	菝
IKH	菽
IKI	菖
IKJ	萜
IKK	萸
IKL	萑
IKM	萆
IKN	菔
IKO	菟
IKP	萏
IKQ	萃
IKR	菸
IKS	菹
IKT	菪
IKU	菅
IKV	菀
IKW	萦
IKX	菰
IKY	菡
IKZ	葜
ILA	葑
ILB	葚
ILC	葙
ILD	葳
ILE	蒇
ILF	蒈
ILG	葺
ILH	蒉
ILI	葸
ILJ	萼
ILK	葆
ILL	葩
ILM	葶
ILN	蒌
ILO	蒎
ILP	萱
ILQ	葭
ILR	蓁
ILS	蓍
ILT	蓐
ILU	蓦
ILV	蒽
ILW	蓓
ILX	蓊
ILY	蒿
ILZ	蒺
IMA	蓠
IMB	蒡
IMC	蒹
IMD	蒴
IME	蒗
IMF	蓥
IMG	蓣
IMH	蔌
IMI	甍
IMJ	蔸
IMK	蓰
IML	蔹
IMM	蔟
IMN	蔺
IMO	蕖
IMP	蔻
IMQ	蓿
IMR	蓼
IMS	蕙
IMT	蕈
IMU	蕨
IMV	蕤
IMW	蕞
IMX	蕺
IMY	瞢
IMZ	蕃
INA	蕲
INB	蕻
INC	薤
IND	薨
INE	薇
INF	薏
ING	蕹
INH	薮
INI	薜
INJ	薅
INK	薹
INL	薷
INM	薰
INN	藓
INO	藁
INP	藜
INQ	藿
INR	蘧
INS	蘅
INT	蘩
INU	蘖
INV	蘼
INW	廾
INX	弈
INY	夼
INZ	奁
IOA	耷
IOB	奕
IOC	奚
IOD	奘
IOE	匏
IOF	尢
IOG	尥
IOH	尬
IOI	尴
IOJ	扌
IOK	扪
IOL	抟
IOM	抻
ION	拊
IOO	拚
IOP	拗
IOQ	拮
IOR	挢
IOS	拶
IOT	挹
IOU	捋
IOV	捃
IOW	掭
IOX	揶
IOY	捱
IOZ	捺
IPA	掎
IPB	掴
IPC	捭
IPD	掬
IPE	掊
IPF	捩
IPG	掮
IPH	掼
IPI	揲
IPJ	揸
IPK	揠
IPL	揿
IPM	揄
IPN	揞
IPO	揎
IPP	摒
IPQ	揆
IPR	掾
IPS	摅
IPT	摁
IPU	搋
IPV	搛
IPW	搠
IPX	搌
IPY	搦
IPZ	搡
IQA	摞
IQB	撄
IQC	摭
IQD	撖
IQE	摺
IQF	撷
IQG	撸
IQH	撙
IQI	撺
IQJ	擀
IQK	擐
IQL	擗
IQM	擤
IQN	擢
IQO	攉
IQP	攥
IQQ	攮
IQR	弋
IQS	忒
IQT	甙
IQU	弑
IQV	卟
IQW	叱
IQX	叽
IQY	叩
IQZ	叨
IRA	叻
IRB	吒
IRC	吖
IRD	吆
IRE	呋
IRF	呒
IRG	呓
IRH	呔
IRI	呖
IRJ	呃
IRK	吡
IRL	呗
IRM	呙
IRN	吣
IRO	吲
IRP	咂
IRQ	咔
IRR	呷
IRS	呱
IRT	呤
IRU	咚
IRV	咛
IRW	咄
IRX	呶
IRY	呦
IRZ	咝
ISA	哐
ISB	咭
ISC	哂
ISD	咴
ISE	哒
ISF	咧
ISG	咦
ISH	哓
ISI	哔
ISJ	呲
ISK	咣
ISL	哕
ISM	咻
ISN	咿
ISO	哌
ISP	哙
ISQ	哚
ISR	哜
ISS	咩
IST	咪
ISU	咤
ISV	哝
ISW	哏
ISX	哞
ISY	唛
ISZ	哧
ITA	唠
ITB	哽
ITC	唔
ITD	哳
ITE	唢
ITF	唣
ITG	唏
ITH	唑
ITI	唧
ITJ	唪
ITK	啧
ITL	喏
ITM	喵
ITN	啉
ITO	啭
ITP	啁
ITQ	啕
ITR	唿
ITS	啐
ITT	唼
ITU	唷
ITV	啖
ITW	啵
ITX	啶
ITY	啷
ITZ	唳
IUA	唰
IUB	啜
IUC	喋
IUD	嗒
IUE	喃
IUF	喱
IUG	喹
IUH	喈
IUI	喁
IUJ	喟
IUK	啾
IUL	嗖
IUM	喑
IUN	啻
IUO	嗟
IUP	喽
IUQ	喾
IUR	喔
IUS	喙
IUT	嗪
IUU	嗷
IUV	嗉
IUW	嘟
IUX	嗑
IUY	嗫
IUZ	嗬
IVA	嗔
IVB	嗦
IVC	嗝
IVD	嗄
IVE	嗯
IVF	嗥
IVG	嗲
IVH	嗳
IVI	嗌
IVJ	嗍
IVK	嗨
IVL	嗵
IVM	嗤
IVN	辔
IVO	嘞
IVP	嘈
IVQ	嘌
IVR	嘁
IVS	嘤
IVT	嘣
IVU	嗾
IVV	嘀
IVW	嘧
IVX	嘭
IVY	噘
IVZ	嘹
IWA	噗
IWB	嘬
IWC	噍
IWD	噢
IWE	噙
IWF	噜
IWG	噌
IWH	噔
IWI	嚆
IWJ	噤
IWK	噱
IWL	噫
IWM	噻
IWN	噼
IWO	嚅
IWP	嚓
IWQ	嚯
IWR	囔
IWS	囗
IWT	囝
IWU	囡
IWV	囵
IWW	囫
IWX	囹
IWY	囿
IWZ	圄
IXA	圊
IXB	圉
IXC	圜
IXD	帏
IXE	帙
IXF	帔
IXG	帑
IXH	帱
IXI	帻
IXJ	帼
IXK	帷
IXL	幄
IXM	幔
IXN	幛
IXO	幞
IXP	幡
IXQ	岌
IXR	屺
IXS	岍
IXT	岐
IXU	岖
IXV	岈
IXW	岘
IXX	岙
IXY	岑
IXZ	岚
IYA	岜
IYB	岵
IYC	岢
IYD	岽
IYE	岬
IYF	岫
IYG	岱
IYH	岣
IYI	峁
IYJ	岷
IYK	峄
IYL	峒
IYM	峤
IYN	峋
IYO	峥
IYP	崂
IYQ	崃
IYR	崧
IYS	崦
IYT	崮
IYU	崤
IYV	崞
IYW	崆
IYX	崛
IYY	嵘
IYZ	崾
IZA	崴
IZB	崽
IZC	嵬
IZD	嵛
IZE	嵯
IZF	嵝
IZG	嵫
IZH	嵋
IZI	嵊
IZJ	嵩
IZK	嵴
IZL	嶂
IZM	嶙
IZN	嶝
IZO	豳
IZP	嶷
IZQ	巅
IZR	彳
IZS	彷
IZT	徂
IZU	徇
IZV	徉
IZW	後
IZX	徕
IZY	徙
IZZ	徜
JAA	徨
JAB	徭
JAC	徵
JAD	徼
JAE	衢
JAF	彡
JAG	犭
JAH	犰
JAI	犴
JAJ	犷
JAK	犸
JAL	狃
JAM	狁
JAN	狎
JAO	狍
JAP	狒
JAQ	狨
JAR	狯
JAS	狩
JAT	狲
JAU	狴
JAV	狷
JAW	猁
JAX	狳
JAY	猃
JAZ	狺
JBA	狻
JBB	猗
JBC	猓
JBD	猡
JBE	猊
JBF	猞
JBG	猝
JBH	猕
JBI	猢
JBJ	猹
JBK	猥
JBL	猬
JBM	猸
JBN	猱
JBO	獐
JBP	獍
JBQ	獗
JBR	獠
JBS	獬
JBT	獯
JBU	獾
JBV	舛
JBW	夥
JBX	飧
JBY	夤
JBZ	夂
JCA	饣
JCB	饧
JCC	饨
JCD	饩
JCE	饪
JCF	饫
JCG	饬
JCH	饴
JCI	饷
JCJ	饽
JCK	馀
JCL	馄
JCM	馇
JCN	馊
JCO	馍
JCP	馐
JCQ	馑
JCR	馓
JCS	馔
JCT	馕
JCU	庀
JCV	庑
JCW	庋
JCX	庖
JCY	庥
JCZ	庠
JDA	庹
JDB	庵
JDC	庾
JDD	庳
JDE	赓
JDF	廒
JDG	廑
JDH	廛
JDI	廨
JDJ	廪
JDK	膺
JDL	忄
JDM	忉
JDN	忖
JDO	忏
JDP	怃
JDQ	忮
JDR	怄
JDS	忡
JDT	忤
JDU	忾
JDV	怅
JDW	怆
JDX	忪
JDY	忭
JDZ	忸
JEA	怙
JEB	怵
JEC	怦
JED	怛
JEE	怏
JEF	怍
JEG	怩
JEH	怫
JEI	怊
JEJ	怿
JEK	怡
JEL	恸
JEM	恹
JEN	恻
JEO	恺
JEP	恂
JEQ	恪
JER	恽
JES	悖
JET	悚
JEU	悭
JEV	悝
JEW	悃
JEX	悒
JEY	悌
JEZ	悛
JFA	惬
JFB	悻
JFC	悱
JFD	惝
JFE	惘
JFF	惆
JFG	惚
JFH	悴
JFI	愠
JFJ	愦
JFK	愕
JFL	愣
JFM	惴
JFN	愀
JFO	愎
JFP	愫
JFQ	慊
JFR	慵
JFS	憬
JFT	憔
JFU	憧
JFV	憷
JFW	懔
JFX	懵
JFY	忝
JFZ	隳
JGA	闩
JGB	闫
JGC	闱
JGD	闳
JGE	闵
JGF	闶
JGG	闼
JGH	闾
JGI	阃
JGJ	阄
JGK	阆
JGL	阈
JGM	阊
JGN	阋
JGO	阌
JGP	阍
JGQ	阏
JGR	阒
JGS	阕
JGT	阖
JGU	阗
JGV	阙
JGW	阚
JGX	丬
JGY	爿
JGZ	戕
JHA	氵
JHB	汔
JHC	汜
JHD	汊
JHE	沣
JHF	沅
JHG	沐
JHH	沔
JHI	沌
JHJ	汨
JHK	汩
JHL	汴
JHM	汶
JHN	沆
JHO	沩
JHP	泐
JHQ	泔
JHR	沭
JHS	泷
JHT	泸
JHU	泱
JHV	泗
JHW	沲
JHX	泠
JHY	泖
JHZ	泺
JIA	泫
JIB	泮
JIC	沱
JID	泓
JIE	泯
JIF	泾
JIG	洹
JIH	洧
JII	洌
JIJ	浃
JIK	浈
JIL	洇
JIM	洄
JIN	洙
JIO	洎
JIP	洫
JIQ	浍
JIR	洮
JIS	洵
JIT	洚
JIU	浏
JIV	浒
JIW	浔
JIX	洳
JIY	涑
JIZ	浯
JJA	涞
JJB	涠
JJC	浞
JJD	涓
JJE	涔
JJF	浜
JJG	浠
JJH	浼
JJI	浣
JJJ	渚
JJK	淇
JJL	淅
JJM	淞
JJN	渎
JJO	涿
JJP	淠
JJQ	渑
JJR	淦
JJS	淝
JJT	淙
JJU	渖
JJV	涫
JJW	渌
JJX	涮
JJY	渫
JJZ	湮
JKA	湎
JKB	湫
JKC	溲
JKD	湟
JKE	溆
JKF	湓
JKG	湔
JKH	渲
JKI	渥
JKJ	湄
JKK	滟
JKL	溱
JKM	溘
JKN	滠
JKO	漭
JKP	滢
JKQ	溥
JKR	溧
JKS	溽
JKT	溻
JKU	溷
JKV	滗
JKW	溴
JKX	滏
JKY	溏
JKZ	滂
JLA	溟
JLB	潢
JLC	潆
JLD	潇
JLE	漤
JLF	漕
JLG	滹
JLH	漯
JLI	漶
JLJ	潋
JLK	潴
JLL	漪
JLM	漉
JLN	漩
JLO	澉
JLP	澍
JLQ	澌
JLR	潸
JLS	潲
JLT	潼
JLU	潺
JLV	濑
JLW	濉
JLX	澧
JLY	澹
JLZ	澶
JMA	濂
JMB	濡
JMC	濮
JMD	濞
JME	濠
JMF	濯
JMG	瀚
JMH	瀣
JMI	瀛
JMJ	瀹
JMK	瀵
JML	灏
JMM	灞
JMN	宀
JMO	宄
JMP	宕
JMQ	宓
JMR	宥
JMS	宸
JMT	甯
JMU	骞
JMV	搴
JMW	寤
JMX	寮
JMY	褰
JMZ	寰
JNA	蹇
JNB	謇
JNC	辶
JND	迓
JNE	迕
JNF	迥
JNG	迮
JNH	迤
JNI	迩
JNJ	迦
JNK	迳
JNL	迨
JNM	逅
JNN	逄
JNO	逋
JNP	逦
JNQ	逑
JNR	逍
JNS	逖
JNT	逡
JNU	逵
JNV	逶
JNW	逭
JNX	逯
JNY	遄
JNZ	遑
JOA	遒
JOB	遐
JOC	遨
JOD	遘
JOE	遢
JOF	遛
JOG	暹
JOH	遴
JOI	遽
JOJ	邂
JOK	邈
JOL	邃
JOM	邋
JON	彐
JOO	彗
JOP	彖
JOQ	彘
JOR	尻
JOS	咫
JOT	屐
JOU	屙
JOV	孱
JOW	屣
JOX	屦
JOY	羼
JOZ	弪
JPA	弩
JPB	弭
JPC	艴
JPD	弼
JPE	鬻
JPF	屮
JPG	妁
JPH	妃
JPI	妍
JPJ	妩
JPK	妪
JPL	妣
JPM	妗
JPN	姊
JPO	妫
JPP	妞
JPQ	妤
JPR	姒
JPS	妲
JPT	妯
JPU	姗
JPV	妾
JPW	娅
JPX	娆
JPY	姝
JPZ	娈
JQA	姣
JQB	姘
JQC	姹
JQD	娌
JQE	娉
JQF	娲
JQG	娴
JQH	娑
JQI	娣
JQJ	娓
JQK	婀
JQL	婧
JQM	婊
JQN	婕
JQO	娼
JQP	婢
JQQ	婵
JQR	胬
JQS	媪
JQT	媛
JQU	婷
JQV	婺
JQW	媾
JQX	嫫
JQY	媲
JQZ	嫒
JRA	嫔
JRB	媸
JRC	嫠
JRD	嫣
JRE	嫱
JRF	嫖
JRG	嫦
JRH	嫘
JRI	嫜
JRJ	嬉
JRK	嬗
JRL	嬖
JRM	嬲
JRN	嬷
JRO	孀
JRP	尕
JRQ	尜
JRR	孚
JRS	孥
JRT	孳
JRU	孑
JRV	孓
JRW	孢
JRX	驵
JRY	驷
JRZ	驸
JSA	驺
JSB	驿
JSC	驽
JSD	骀
JSE	骁
JSF	骅
JSG	骈
JSH	骊
JSI	骐
JSJ	骒
JSK	骓
JSL	骖
JSM	骘
JSN	骛
JSO	骜
JSP	骝
JSQ	骟
JSR	骠
JSS	骢
JST	骣
JSU	骥
JSV	骧
JSW	纟
JSX	纡
JSY	纣
JSZ	纥
JTA	纨
JTB	纩
JTC	纭
JTD	纰
JTE	纾
JTF	绀
JTG	绁
JTH	绂
JTI	绉
JTJ	绋
JTK	绌
JTL	绐
JTM	绔
JTN	绗
JTO	绛
JTP	绠
JTQ	绡
JTR	绨
JTS	绫
JTT	绮
JTU	绯
JTV	绱
JTW	绲
JTX	缍
JTY	绶
JTZ	绺
JUA	绻
JUB	绾
JUC	缁
JUD	缂
JUE	缃
JUF	缇
JUG	缈
JUH	缋
JUI	缌
JUJ	缏
JUK	缑
JUL	缒
JUM	缗
JUN	缙
JUO	缜
JUP	缛
JUQ	缟
JUR	缡
JUS	缢
JUT	缣
JUU	缤
JUV	缥
JUW	缦
JUX	缧
JUY	缪
JUZ	缫
JVA	缬
JVB	缭
JVC	缯
JVD	缰
JVE	缱
JVF	缲
JVG	缳
JVH	缵
JVI	幺
JVJ	畿
JVK	巛
JVL	甾
JVM	邕
JVN	玎
JVO	玑
JVP	玮
JVQ	玢
JVR	玟
JVS	珏
JVT	珂
JVU	珑
JVV	玷
JVW	玳
JVX	珀
JVY	珉
JVZ	珈
JWA	珥
JWB	珙
JWC	顼
JWD	琊
JWE	珩
JWF	珧
JWG	珞
JWH	玺
JWI	珲
JWJ	琏
JWK	琪
JWL	瑛
JWM	琦
JWN	琥
JWO	琨
JWP	琰
JWQ	琮
JWR	琬
JWS	琛
JWT	琚
JWU	瑁
JWV	瑜
JWW	瑗
JWX	瑕
JWY	瑙
JWZ	瑷
JXA	瑭
JXB	瑾
JXC	璜
JXD	璎
JXE	璀
JXF	璁
JXG	璇
JXH	璋
JXI	璞
JXJ	璨
JXK	璩
JXL	璐
JXM	璧
JXN	瓒
JXO	璺
JXP	韪
JXQ	韫
JXR	韬
JXS	杌
JXT	杓
JXU	杞
JXV	杈
JXW	杩
JXX	枥
JXY	枇
JXZ	杪
JYA	杳
JYB	枘
JYC	枧
JYD	杵
JYE	枨
JYF	枞
JYG	枭
JYH	枋
JYI	杷
JYJ	杼
JYK	柰
JYL	栉
JYM	柘
JYN	栊
JYO	柩
JYP	枰
JYQ	栌
JYR	柙
JYS	枵
JYT	柚
JYU	枳
JYV	柝
JYW	栀
JYX	柃
JYY	枸
JYZ	柢
JZA	栎
JZB	柁
JZC	柽
JZD	栲
JZE	栳
JZF	桠
JZG	桡
JZH	桎
JZI	桢
JZJ	桄
JZK	桤
JZL	梃
JZM	栝
JZN	桕
JZO	桦
JZP	桁
JZQ	桧
JZR	桀
JZS	栾
JZT	桊
JZU	桉
JZV	栩
JZW	梵
JZX	梏
JZY	桴
JZZ	桷
KAA	梓
KAB	桫
KAC	棂
KAD	楮
KAE	棼
KAF	椟
KAG	椠
KAH	棹
KAI	椤
KAJ	棰
KAK	椋
KAL	椁
KAM	楗
KAN	棣
KAO	椐
KAP	楱
KAQ	椹
KAR	楠
KAS	楂
KAT	楝
KAU	榄
KAV	楫
KAW	榀
KAX	榘
KAY	楸
KAZ	椴
KBA	槌
KBB	榇
KBC	榈
KBD	槎
KBE	榉
KBF	楦
KBG	楣
KBH	楹
KBI	榛
KBJ	榧
KBK	榻
KBL	榫
KBM	榭
KBN	槔
KBO	榱
KBP	槁
KBQ	槊
KBR	槟
KBS	榕
KBT	槠
KBU	榍
KBV	槿
KBW	樯
KBX	槭
KBY	樗
KBZ	樘
KCA	橥
KCB	槲
KCC	橄
KCD	樾
KCE	檠
KCF	橐
KCG	橛
KCH	樵
KCI	檎
KCJ	橹
KCK	樽
KCL	樨
KCM	橘
KCN	橼
KCO	檑
KCP	檐
KCQ	檩
KCR	檗
KCS	檫
KCT	猷
KCU	獒
KCV	殁
KCW	殂
KCX	殇
KCY	殄
KCZ	殒
KDA	殓
KDB	殍
KDC	殚
KDD	殛
KDE	殡
KDF	殪
KDG	轫
KDH	轭
KDI	轱
KDJ	轲
KDK	轳
KDL	轵
KDM	轶
KDN	轸
KDO	轷
KDP	轹
KDQ	轺
KDR	轼
KDS	轾
KDT	辁
KDU	辂
KDV	辄
KDW	辇
KDX	辋
KDY	辍
KDZ	辎
KEA	辏
KEB	辘
KEC	辚
KED	軎
KEE	戋
KEF	戗
KEG	戛
KEH	戟
KEI	戢
KEJ	戡
KEK	戥
KEL	戤
KEM	戬
KEN	臧
KEO	瓯
KEP	瓴
KEQ	瓿
KER	甏
KES	甑
KET	甓
KEU	攴
KEV	旮
KEW	旯
KEX	旰
KEY	昊
KEZ	昙
KFA	杲
KFB	昃
KFC	昕
KFD	昀
KFE	炅
KFF	曷
KFG	昝
KFH	昴
KFI	昱
KFJ	昶
KFK	昵
KFL	耆
KFM	晟
KFN	晔
KFO	晁
KFP	晏
KFQ	晖
KFR	晡
KFS	晗
KFT	晷
KFU	暄
KFV	暌
KFW	暧
KFX	暝
KFY	暾
KFZ	曛
KGA	曜
KGB	曦
KGC	曩
KGD	贲
KGE	贳
KGF	贶
KGG	贻
KGH	贽
KGI	赀
KGJ	赅
KGK	赆
KGL	赈
KGM	赉
KGN	赇
KGO	赍
KGP	赕
KGQ	赙
KGR	觇
KGS	觊
KGT	觋
KGU	觌
KGV	觎
KGW	觏
KGX	觐
KGY	觑
KGZ	牮
KHA	犟
KHB	牝
KHC	牦
KHD	牯
KHE	牾
KHF	牿
KHG	犄
KHH	犋
KHI	犍
KHJ	犏
KHK	犒
KHL	挈
KHM	挲
KHN	掰
KHO	搿
KHP	擘
KHQ	耄
KHR	毪
KHS	毳
KHT	毽
KHU	毵
KHV	毹
KHW	氅
KHX	氇
KHY	氆
KHZ	氍
KIA	氕
KIB	氘
KIC	氙
KID	氚
KIE	氡
KIF	氩
KIG	氤
KIH	氪
KII	氲
KIJ	攵
KIK	敕
KIL	敫
KIM	牍
KIN	牒
KIO	牖
KIP	爰
KIQ	虢
KIR	刖
KIS	肟
KIT	肜
KIU	肓
KIV	肼
KIW	朊
KIX	肽
KIY	肱
KIZ	肫
KJA	肭
KJB	肴
KJC	肷
KJD	胧
KJE	胨
KJF	胩
KJG	胪
KJH	胛
KJI	胂
KJJ	胄
KJK	胙
KJL	胍
KJM	胗
KJN	朐
KJO	胝
KJP	胫
KJQ	胱
KJR	胴
KJS	胭
KJT	脍
KJU	脎
KJV	胲
KJW	胼
KJX	朕
KJY	脒
KJZ	豚
KKA	脶
KKB	脞
KKC	脬
KKD	脘
KKE	脲
KKF	腈
KKG	腌
KKH	腓
KKI	腴
KKJ	腙
KKK	腚
KKL	腱
KKM	腠
KKN	腩
KKO	腼
KKP	腽
KKQ	腭
KKR	腧
KKS	塍
KKT	媵
KKU	膈
KKV	膂
KKW	膑
KKX	滕
KKY	膣
KKZ	膪
KLA	臌
KLB	朦
KLC	臊
KLD	膻
KLE	臁
KLF	膦
KLG	欤
KLH	欷
KLI	欹
KLJ	歃
KLK	歆
KLL	歙
KLM	飑
KLN	飒
KLO	飓
KLP	飕
KLQ	飙
KLR	飚
KLS	殳
KLT	彀
KLU	毂
KLV	觳
KLW	斐
KLX	齑
KLY	斓
KLZ	於
KMA	旆
KMB	旄
KMC	旃
KMD	旌
KME	旎
KMF	旒
KMG	旖
KMH	炀
KMI	炜
KMJ	炖
KMK	炝
KML	炻
KMM	烀
KMN	炷
KMO	炫
KMP	炱
KMQ	烨
KMR	烊
KMS	焐
KMT	焓
KMU	焖
KMV	焯
KMW	焱
KMX	煳
KMY	煜
KMZ	煨
KNA	煅
KNB	煲
KNC	煊
KND	煸
KNE	煺
KNF	熘
KNG	熳
KNH	熵
KNI	熨
KNJ	熠
KNK	燠
KNL	燔
KNM	燧
KNN	燹
KNO	爝
KNP	爨
KNQ	灬
KNR	焘
KNS	煦
KNT	熹
KNU	戾
KNV	戽
KNW	扃
KNX	扈
KNY	扉
KNZ	礻
KOA	祀
KOB	祆
KOC	祉
KOD	祛
KOE	祜
KOF	祓
KOG	祚
KOH	祢
KOI	祗
KOJ	祠
KOK	祯
KOL	祧
KOM	祺
KON	禅
KOO	禊
KOP	禚
KOQ	禧
KOR	禳
KOS	忑
KOT	忐
KOU	怼
KOV	恝
KOW	恚
KOX	恧
KOY	恁
KOZ	恙
KPA	恣
KPB	悫
KPC	愆
KPD	愍
KPE	慝
KPF	憩
KPG	憝
KPH	懋
KPI	懑
KPJ	戆
KPK	肀
KPL	聿
KPM	沓
KPN	泶
KPO	淼
KPP	矶
KPQ	矸
KPR	砀
KPS	砉
KPT	砗
KPU	砘
KPV	砑
KPW	斫
KPX	砭
KPY	砜
KPZ	砝
KQA	砹
KQB	砺
KQC	砻
KQD	砟
KQE	砼
KQF	砥
KQG	砬
KQH	砣
KQI	砩
KQJ	硎
KQK	硭
KQL	硖
KQM	硗
KQN	砦
KQO	硐
KQP	硇
KQQ	硌
KQR	硪
KQS	碛
KQT	碓
KQU	碚
KQV	碇
KQW	碜
KQX	碡
KQY	碣
KQZ	碲
KRA	碹
KRB	碥
KRC	磔
KRD	磙
KRE	磉
KRF	磬
KRG	磲
KRH	礅
KRI	磴
KRJ	礓
KRK	礤
KRL	礞
KRM	礴
KRN	龛
KRO	黹
KRP	黻
KRQ	黼
KRR	盱
KRS	眄
KRT	眍
KRU	盹
KRV	眇
KRW	眈
KRX	眚
KRY	眢
KRZ	眙
KSA	眭
KSB	眦
KSC	眵
KSD	眸
KSE	睐
KSF	睑
KSG	睇
KSH	睃
KSI	睚
KSJ	睨
KSK	睢
KSL	睥
KSM	睿
KSN	瞍
KSO	睽
KSP	瞀
KSQ	瞌
KSR	瞑
KSS	瞟
KST	瞠
KSU	瞰
KSV	瞵
KSW	瞽
KSX	町
KSY	畀
KSZ	畎
KTA	畋
KTB	畈
KTC	畛
KTD	畲
KTE	畹
KTF	疃
KTG	罘
KTH	罡
KTI	罟
KTJ	詈
KTK	罨
KTL	罴
KTM	罱
KTN	罹
KTO	羁
KTP	罾
KTQ	盍
KTR	盥
KTS	蠲
KTT	钅
KTU	钆
KTV	钇
KTW	钋
KTX	钊
KTY	钌
KTZ	钍
KUA	钏
KUB	钐
KUC	钔
KUD	钗
KUE	钕
KUF	钚
KUG	钛
KUH	钜
KUI	钣
KUJ	钤
KUK	钫
KUL	钪
KUM	钭
KUN	钬
KUO	钯
KUP	钰
KUQ	钲
KUR	钴
KUS	钶
KUT	钷
KUU	钸
KUV	钹
KUW	钺
KUX	钼
KUY	钽
KUZ	钿
KVA	铄
KVB	铈
KVC	铉
KVD	铊
KVE	铋
KVF	铌
KVG	铍
KVH	铎
KVI	铐
KVJ	铑
KVK	铒
KVL	铕
KVM	铖
KVN	铗
KVO	铙
KVP	铘
KVQ	铛
KVR	铞
KVS	铟
KVT	铠
KVU	铢
KVV	铤
KVW	铥
KVX	铧
KVY	铨
KVZ	铪
KWA	铩
KWB	铫
KWC	铮
KWD	铯
KWE	铳
KWF	铴
KWG	铵
KWH	铷
KWI	铹
KWJ	铼
KWK	铽
KWL	铿
KWM	锃
KWN	锂
KWO	锆
KWP	锇
KWQ	锉
KWR	锊
KWS	锍
KWT	锎
KWU	锏
KWV	锒
KWW	锓
KWX	锔
KWY	锕
KWZ	锖
KXA	锘
KXB	锛
KXC	锝
KXD	锞
KXE	锟
KXF	锢
KXG	锪
KXH	锫
KXI	锩
KXJ	锬
KXK	锱
KXL	锲
KXM	锴
KXN	锶
KXO	锷
KXP	锸
KXQ	锼
KXR	锾
KXS	锿
KXT	镂
KXU	锵
KXV	镄
KXW	镅
KXX	镆
KXY	镉
KXZ	镌
KYA	镎
KYB	镏
KYC	镒
KYD	镓
KYE	镔
KYF	镖
KYG	镗
KYH	镘
KYI	镙
KYJ	镛
KYK	镞
KYL	镟
KYM	镝
KYN	镡
KYO	镢
KYP	镤
KYQ	镥
KYR	镦
KYS	镧
KYT	镨
KYU	镩
KYV	镪
KYW	镫
KYX	镬
KYY	镯
KYZ	镱
KZA	镲
KZB	镳
KZC	锺
KZD	矧
KZE	矬
KZF	雉
KZG	秕
KZH	秭
KZI	秣
KZJ	秫
KZK	稆
KZL	嵇
KZM	稃
KZN	稂
KZO	稞
KZP	稔
KZQ	稹
KZR	稷
KZS	穑
KZT	黏
KZU	馥
KZV	穰
KZW	皈
KZX	皎
KZY	皓
KZZ	皙
LAA	皤
LAB	瓞
LAC	瓠
LAD	甬
LAE	鸠
LAF	鸢
LAG	鸨
LAH	鸩
LAI	鸪
LAJ	鸫
LAK	鸬
LAL	鸲
LAM	鸱
LAN	鸶
LAO	鸸
LAP	鸷
LAQ	鸹
LAR	鸺
LAS	鸾
LAT	鹁
LAU	鹂
LAV	鹄
LAW	鹆
LAX	鹇
LAY	鹈
LAZ	鹉
LBA	鹋
LBB	鹌
LBC	鹎
LBD	鹑
LBE	鹕
LBF	鹗
LBG	鹚
LBH	鹛
LBI	鹜
LBJ	鹞
LBK	鹣
LBL	鹦
LBM	鹧
LBN	鹨
LBO	鹩
LBP	鹪
LBQ	鹫
LBR	鹬
LBS	鹱
LBT	鹭
LBU	鹳
LBV	疒
LBW	疔
LBX	疖
LBY	疠
LBZ	疝
LCA	疬
LCB	疣
LCC	疳
LCD	疴
LCE	疸
LCF	痄
LCG	疱
LCH	疰
LCI	痃
LCJ	痂
LCK	痖
LCL	痍
LCM	痣
LCN	痨
LCO	痦
LCP	痤
LCQ	痫
LCR	痧
LCS	瘃
LCT	痱
LCU	痼
LCV	痿
LCW	瘐
LCX	瘀
LCY	瘅
LCZ	瘌
LDA	瘗
LDB	瘊
LDC	瘥
LDD	瘘
LDE	瘕
LDF	瘙
LDG	瘛
LDH	瘼
LDI	瘢
LDJ	瘠
LDK	癀
LDL	瘭
LDM	瘰
LDN	瘿
LDO	瘵
LDP	癃
LDQ	瘾
LDR	瘳
LDS	癍
LDT	癞
LDU	癔
LDV	癜
LDW	癖
LDX	癫
LDY	癯
LDZ	翊
LEA	竦
LEB	穸
LEC	穹
LED	窀
LEE	窆
LEF	窈
LEG	窕
LEH	窦
LEI	窠
LEJ	窬
LEK	窨
LEL	窭
LEM	窳
LEN	衤
LEO	衩
LEP	衲
LEQ	衽
LER	衿
LES	袂
LET	袢
LEU	裆
LEV	袷
LEW	袼
LEX	裉
LEY	裢
LEZ	裎
LFA	裣
LFB	裥
LFC	裱
LFD	褚
LFE	裼
LFF	裨
LFG	裾
LFH	裰
LFI	褡
LFJ	褙
LFK	褓
LFL	褛
LFM	褊
LFN	褴
LFO	褫
LFP	褶
LFQ	襁
LFR	襦
LFS	襻
LFT	疋
LFU	胥
LFV	皲
LFW	皴
LFX	矜
LFY	耒
LFZ	耔
LGA	耖
LGB	耜
LGC	耠
LGD	耢
LGE	耥
LGF	耦
LGG	耧
LGH	耩
LGI	耨
LGJ	耱
LGK	耋
LGL	耵
LGM	聃
LGN	聆
LGO	聍
LGP	聒
LGQ	聩
LGR	聱
LGS	覃
LGT	顸
LGU	颀
LGV	颃
LGW	颉
LGX	颌
LGY	颍
LGZ	颏
LHA	颔
LHB	颚
LHC	颛
LHD	颞
LHE	颟
LHF	颡
LHG	颢
LHH	颥
LHI	颦
LHJ	虍
LHK	虔
LHL	虬
LHM	虮
LHN	虿
LHO	虺
LHP	虼
LHQ	虻
LHR	蚨
LHS	蚍
LHT	蚋
LHU	蚬
LHV	蚝
LHW	蚧
LHX	蚣
LHY	蚪
LHZ	蚓
LIA	蚩
LIB	蚶
LIC	蛄
LID	蚵
LIE	蛎
LIF	蚰
LIG	蚺
LIH	蚱
LII	蚯
LIJ	蛉
LIK	蛏
LIL	蚴
LIM	蛩
LIN	蛱
LIO	蛲
LIP	蛭
LIQ	蛳
LIR	蛐
LIS	蜓
LIT	蛞
LIU	蛴
LIV	蛟
LIW	蛘
LIX	蛑
LIY	蜃
LIZ	蜇
LJA	蛸
LJB	蜈
LJC	蜊
LJD	蜍
LJE	蜉
LJF	蜣
LJG	蜻
LJH	蜞
LJI	蜥
LJJ	蜮
LJK	蜚
LJL	蜾
LJM	蝈
LJN	蜴
LJO	蜱
LJP	蜩
LJQ	蜷
LJR	蜿
LJS	螂
LJT	蜢
LJU	蝽
LJV	蝾
LJW	蝻
LJX	蝠
LJY	蝰
LJZ	蝌
LKA	蝮
LKB	螋
LKC	蝓
LKD	蝣
LKE	蝼
LKF	蝤
LKG	蝙
LKH	蝥
LKI	螓
LKJ	螯
LKK	螨
LKL	蟒
LKM	蟆
LKN	螈
LKO	螅
LKP	螭
LKQ	螗
LKR	螃
LKS	螫
LKT	蟥
LKU	螬
LKV	螵
LKW	螳
LKX	蟋
LKY	蟓
LKZ	螽
LLA	蟑
LLB	蟀
LLC	蟊
LLD	蟛
LLE	蟪
LLF	蟠
LLG	蟮
LLH	蠖
LLI	蠓
LLJ	蟾
LLK	蠊
LLL	蠛
LLM	蠡
LLN	蠹
LLO	蠼
LLP	缶
LLQ	罂
LLR	罄
LLS	罅
LLT	舐
LLU	竺
LLV	竽
LLW	笈
LLX	笃
LLY	笄
LLZ	笕
LMA	笊
LMB	笫
LMC	笏
LMD	筇
LME	笸
LMF	笪
LMG	笙
LMH	笮
LMI	笱
LMJ	笠
LMK	笥
LML	笤
LMM	笳
LMN	笾
LMO	笞
LMP	筘
LMQ	筚
LMR	筅
LMS	筵
LMT	筌
LMU	筝
LMV	筠
LMW	筮
LMX	筻
LMY	筢
LMZ	筲
LNA	筱
LNB	箐
LNC	箦
LND	箧
LNE	箸
LNF	箬
LNG	箝
LNH	箨
LNI	箅
LNJ	箪
LNK	箜
LNL	箢
LNM	箫
LNN	箴
LNO	篑
LNP	篁
LNQ	篌
LNR	篝
LNS	篚
LNT	篥
LNU	篦
LNV	篪
LNW	簌
LNX	篾
LNY	篼
LNZ	簏
LOA	簖
LOB	簋
LOC	簟
LOD	簪
LOE	簦
LOF	簸
LOG	籁
LOH	籀
LOI	臾
LOJ	舁
LOK	舂
LOL	舄
LOM	臬
LON	衄
LOO	舡
LOP	舢
LOQ	舣
LOR	舭
LOS	舯
LOT	舨
LOU	舫
LOV	舸
LOW	舻
LOX	舳
LOY	舴
LOZ	舾
LPA	艄
LPB	艉
LPC	艋
LPD	艏
LPE	艚
LPF	艟
LPG	艨
LPH	衾
LPI	袅
LPJ	袈
LPK	裘
LPL	裟
LPM	襞
LPN	羝
LPO	羟
LPP	羧
LPQ	羯
LPR	羰
LPS	羲
LPT	籼
LPU	敉
LPV	粑
LPW	粝
LPX	粜
LPY	粞
LPZ	粢
LQA	粲
LQB	粼
LQC	粽
LQD	糁
LQE	糇
LQF	糌
LQG	糍
LQH	糈
LQI	糅
LQJ	糗
LQK	糨
LQL	艮
LQM	暨
LQN	羿
LQO	翎
LQP	翕
LQQ	翥
LQR	翡
LQS	翦
LQT	翩
LQU	翮
LQV	翳
LQW	糸
LQX	絷
LQY	綦
LQZ	綮
LRA	繇
LRB	纛
LRC	麸
LRD	麴
LRE	赳
LRF	趄
LRG	趔
LRH	趑
LRI	趱
LRJ	赧
LRK	赭
LRL	豇
LRM	豉
LRN	酊
LRO	酐
LRP	酎
LRQ	酏
LRR	酤
LRS	酢
LRT	酡
LRU	酰
LRV	酩
LRW	酯
LRX	酽
LRY	酾
LRZ	酲
LSA	酴
LSB	酹
LSC	醌
LSD	醅
LSE	醐
LSF	醍
LSG	醑
LSH	醢
LSI	醣
LSJ	醪
LSK	醭
LSL	醮
LSM	醯
LSN	醵
LSO	醴
LSP	醺
LSQ	豕
LSR	鹾
LSS	趸
LST	跫
LSU	踅
LSV	蹙
LSW	蹩
LSX	趵
LSY	趿
LSZ	趼
LTA	趺
LTB	跄
LTC	跖
LTD	跗
LTE	跚
LTF	跞
LTG	跎
LTH	跏
LTI	跛
LTJ	跆
LTK	跬
LTL	跷
LTM	跸
LTN	跣
LTO	跹
LTP	跻
LTQ	跤
LTR	踉
LTS	跽
LTT	踔
LTU	踝
LTV	踟
LTW	踬
LTX	踮
LTY	踣
LTZ	踯
LUA	踺
LUB	蹀
LUC	踹
LUD	踵
LUE	踽
LUF	踱
LUG	蹉
LUH	蹁
LUI	蹂
LUJ	蹑
LUK	蹒
LUL	蹊
LUM	蹰
LUN	蹶
LUO	蹼
LUP	蹯
LUQ	蹴
LUR	躅
LUS	躏
LUT	躔
LUU	躐
LUV	躜
LUW	躞
LUX	豸
LUY	貂
LUZ	貊
LVA	貅
LVB	貘
LVC	貔
LVD	斛
LVE	觖
LVF	觞
LVG	觚
LVH	觜
LVI	觥
LVJ	觫
LVK	觯
LVL	訾
LVM	謦
LVN	靓
LVO	雩
LVP	雳
LVQ	雯
LVR	霆
LVS	霁
LVT	霈
LVU	霏
LVV	霎
LVW	霪
LVX	霭
LVY	霰
LVZ	霾
LWA	龀
LWB	龃
LWC	龅
LWD	龆
LWE	龇
LWF	龈
LWG	龉
LWH	龊
LWI	龌
LWJ	黾
LWK	鼋
LWL	鼍
LWM	隹
LWN	隼
LWO	隽
LWP	雎
LWQ	雒
LWR	瞿
LWS	雠
LWT	銎
LWU	銮
LWV	鋈
LWW	錾
LWX	鍪
LWY	鏊
LWZ	鎏
LXA	鐾
LXB	鑫
LXC	鱿
LXD	鲂
LXE	鲅
LXF	鲆
LXG	鲇
LXH	鲈
LXI	稣
LXJ	鲋
LXK	鲎
LXL	鲐
LXM	鲑
LXN	鲒
LXO	鲔
LXP	鲕
LXQ	鲚
LXR	鲛
LXS	鲞
LXT	鲟
LXU	鲠
LXV	鲡
LXW	鲢
LXX	鲣
LXY	鲥
LXZ	鲦
LYA	鲧
LYB	鲨
LYC	鲩
LYD	鲫
LYE	鲭
LYF	鲮
LYG	鲰
LYH	鲱
LYI	鲲
LYJ	鲳
LYK	鲴
LYL	鲵
LYM	鲶
LYN	鲷
LYO	鲺
LYP	鲻
LYQ	鲼
LYR	鲽
LYS	鳄
LYT	鳅
LYU	鳆
LYV	鳇
LYW	鳊
LYX	鳋
LYY	鳌
LYZ	鳍
LZA	鳎
LZB	鳏
LZC	鳐
LZD	鳓
LZE	鳔
LZF	鳕
LZG	鳗
LZH	鳘
LZI	鳙
LZJ	鳜
LZK	鳝
LZL	鳟
LZM	鳢
LZN	靼
LZO	鞅
LZP	鞑
LZQ	鞒
LZR	鞔
LZS	鞯
LZT	鞫
LZU	鞣
LZV	鞲
LZW	鞴
LZX	骱
LZY	骰
LZZ	骷
MAA	鹘
MAB	骶
MAC	骺
MAD	骼
MAE	髁
MAF	髀
MAG	髅
MAH	髂
MAI	髋
MAJ	髌
MAK	髑
MAL	魅
MAM	魃
MAN	魇
MAO	魉
MAP	魈
MAQ	魍
MAR	魑
MAS	飨
MAT	餍
MAU	餮
MAV	饕
MAW	饔
MAX	髟
MAY	髡
MAZ	髦
MBA	髯
MBB	髫
MBC	髻
MBD	髭
MBE	髹
MBF	鬈
MBG	鬏
MBH	鬓
MBI	鬟
MBJ	鬣
MBK	麽
MBL	麾
MBM	縻
MBN	麂
MBO	麇
MBP	麈
MBQ	麋
MBR	麒
MBS	鏖
MBT	麝
MBU	麟
MBV	黛
MBW	黜
MBX	黝
MBY	黠
MBZ	黟
MCA	黢
MCB	黩
MCC	黧
MCD	黥
MCE	黪
MCF	黯
MCG	鼢
MCH	鼬
MCI	鼯
MCJ	鼹
MCK	鼷
MCL	鼽
MCM	鼾
MCN	齄
